"a" = (/turf/unsimulated/wall/planetary/athena,/area/odysseybase/level3/nw)
"b" = (/turf/simulated/open/athena,/area/odysseybase/level3/nw)
"e" = (/obj/structure/railing/grey{dir = 8},/turf/simulated/open/athena,/area/odysseybase/level3/sw)
"f" = (/turf/simulated/open/athena,/area/odysseybase/level3/se)
"g" = (/turf/simulated/open/athena,/area/odysseybase/level3/sw)
"j" = (/turf/simulated/floor/outdoors/newdirt_nograss/athena,/area/odysseybase/level3/se)
"k" = (/turf/unsimulated/wall/planetary/normal/athena,/area/odysseybase/level3/nw)
"m" = (/turf/unsimulated/wall/planetary/normal/athena,/area/odysseybase/level3/sw)
"n" = (/turf/simulated/mineral/athena,/area/odysseybase/level3/nw)
"o" = (/turf/simulated/mineral/athena,/area/odysseybase/level3/se)
"r" = (/obj/structure/railing/grey{dir = 1},/obj/structure/railing/grey{dir = 8},/turf/simulated/open/athena,/area/odysseybase/level3/sw)
"s" = (/turf/simulated/floor/outdoors/sidewalk/slab/athena,/area/odysseybase/level3/se)
"t" = (/turf/unsimulated/wall/planetary/athena,/area/odysseybase/level3/sw)
"w" = (/obj/structure/railing/grey{dir = 4},/turf/simulated/open/athena,/area/odysseybase/level3/se)
"x" = (/turf/unsimulated/wall/planetary/athena,/area/odysseybase/level3/ne)
"y" = (/turf/simulated/open/athena,/area/odysseybase/level3/ne)
"z" = (/turf/simulated/floor/outdoors/newdirt_nograss/athena,/area/odysseybase/level3/sw)
"B" = (/turf/unsimulated/wall/planetary/normal/athena,/area/odysseybase/level3/ne)
"C" = (/turf/unsimulated/wall/planetary/athena,/area/odysseybase/level3/se)
"D" = (/turf/simulated/floor/outdoors/sidewalk/slab/athena,/area/odysseybase/level3/sw)
"E" = (/obj/structure/railing/grey{dir = 1},/obj/structure/railing/grey{dir = 4},/turf/simulated/open/athena,/area/odysseybase/level3/sw)
"G" = (/obj/structure/railing/grey{dir = 8},/obj/structure/railing/grey{dir = 1},/turf/simulated/open/athena,/area/odysseybase/level3/se)
"K" = (/obj/structure/railing/grey{dir = 4},/turf/simulated/open/athena,/area/odysseybase/level3/sw)
"M" = (/turf/simulated/mineral/athena,/area/odysseybase/level3/ne)
"S" = (/obj/structure/railing/grey{dir = 4},/obj/structure/railing/grey{dir = 1},/turf/simulated/open/athena,/area/odysseybase/level3/se)
"T" = (/turf/simulated/mineral/athena,/area/odysseybase/level3/sw)
"U" = (/obj/structure/railing/grey{dir = 8},/turf/simulated/open/athena,/area/odysseybase/level3/se)

(1,1,1) = {"
aaaaaaaaaaaaaaaaaaaaaaaaaaaaaaaaaakkkkkkkkkkkkkkkkkkkkkkkkkkkkkkkkkkkBBBBBBBBBBBBBBBBBBBBBBBBBBBBBBBBBBBBBBBBBBBBxxxxxxxxxxxxxxxxxxxxxxxxxx
annnnnnnnnnnnnnnnnnnnnnnnnnnnnnnnnbbbbbbbbbbbbbbbbbbbbbbbbbbbbbbbbbbbyyyyyyyyyyyyyyyyyyyyyyyyyyyyyyyyyyyyyyyyyyyyMMMMMMMMMMMMMMMMMMMMMMMMMM
annnnnnnnnnnnnnnnnnnnnnnnnnnnnnnbbbbbbbbbbbbbbbbbbbbbbbbbbbbbbbbbbbbbyyyyyyyyyyyyyyyyyyyyyyyyyyyyyyyyyyyyyyyyyyyyMMMMMMMMMMMMMMMMMMMMMMMMMM
annnnnnnnnnnnnnnnnnnnnnnnnnnnnbbbbbbbbbbbbbbbbbbbbbbbbbbbbbbbbbbbbbbbyyyyyyyyyyyyyyyyyyyyyyyyyyyyyyyyyyyyyyyyyyyyyMMMMMMMMMMMMMMMMMMMMMMMMM
annnnnnnnnnnnnnnnnnnnnnnnnnnbbbbbbbbbbbbbbbbbbbbbbbbbbbbbbbbbbbbbbbbbyyyyyyyyyyyyyyyyyyyyyyyyyyyyyyyyyyyyyyyyyyyyyyMMMMMMMMMMMMMMMMMMMMMMMM
annnnnnnnnnnnnnnnnnnnnnnnnnbbbbbbbbbbbbbbbbbbbbbbbbbbbbbbbbbbbbbbbbbbyyyyyyyyyyyyyyyyyyyyyyyyyyyyyyyyyyyyyyyyyyyyyyMMMMMMMMMMMMMMMMMMMMMMMM
annnnnnnnnnnnnnnnnnnnnnnnbbbbbbbbbbbbbbbbbbbbbbbbbbbbbbbbbbbbbbbbbbbbyyyyyyyyyyyyyyyyyyyyyyyyyyyyyyyyyyyyyyyyyyyyyyyMMMMMMMMMMMMMMMMMMMMMMM
annnnnnnnnnnnnnnnnnnnnnnbbbbbbbbbbbbbbbbbbbbbbbbbbbbbbbbbbbbbbbbbbbbbyyyyyyyyyyyyyyyyyyyyyyyyyyyyyyyyyyyyyyyyyyyyyyyyMMMMMMMMMMMMMMMMMMMMMM
annnnnnnnnnnnnnnnnnnnnnbbbbbbbbbbbbbbbbbbbbbbbbbbbbbbbbbbbbbbbbbbbbbbyyyyyyyyyyyyyyyyyyyyyyyyyyyyyyyyyyyyyyyyyyyyyyyyMMMMMMMMMMMMMMMMMMMMMM
annnnnnnnnnnnnnnnnnnnbbbbbbbbbbbbbbbbbbbbbbbbbbbbbbbbbbbbbbbbbbbbbbbbyyyyyyyyyyyyyyyyyyyyyyyyyyyyyyyyyyyyyyyyyyyyyyyyMMMMMMMMMMMMMMMMMMMMMM
annnnnnnnnnnnnnnnbbbbbbbbbbbbbbbbbbbbbbbbbbbbbbbbbbbbbbbbbbbbbbbbbbbbyyyyyyyyyyyyyyyyyyyyyyyyyyyyyyyyyyyyyyyyyyyyyyyyyMMMMMMMMMMMMMMMMMMMMM
annnnnnnnnnnbbbbbbbbbbbbbbbbbbbbbbbbbbbbbbbbbbbbbbbbbbbbbbbbbbbbbbbbbyyyyyyyyyyyyyyyyyyyyyyyyyyyyyyyyyyyyyyyyyyyyyyyyyMMMMMMMMMMMMMMMMMMMMM
annnnbbbbbbbbbbbbbbbbbbbbbbbbbbbbbbbbbbbbbbbbbbbbbbbbbbbbbbbbbbbbbbbbyyyyyyyyyyyyyyyyyyyyyyyyyyyyyyyyyyyyyyyyyyyyyyyyyyMMMMMMMMMMMMMMMMMMMM
annbbbbbbbbbbbbbbbbbbbbbbbbbbbbbbbbbbbbbbbbbbbbbbbbbbbbbbbbbbbbbbbbbbyyyyyyyyyyyyyyyyyyyyyyyyyyyyyyyyyyyyyyyyyyyyyyyyyyMMMMMMMMMMMMMMMMMMMM
anbbbbbbbbbbbbbbbbbbbbbbbbbbbbbbbbbbbbbbbbbbbbbbbbbbbbbbbbbbbbbbbbbbbyyyyyyyyyyyyyyyyyyyyyyyyyyyyyyyyyyyyyyyyyyyyyyyyyyyMMMMMMMMMMMMMMMMMMM
kbbbbbbbbbbbbbbbbbbbbbbbbbbbbbbbbbbbbbbbbbbbbbbbbbbbbbbbbbbbbbbbbbbbbyyyyyyyyyyyyyyyyyyyyyyyyyyyyyyyyyyyyyyyyyyyyyyyyyyyMMMMMMMMMMMMMMMMMMM
kbbbbbbbbbbbbbbbbbbbbbbbbbbbbbbbbbbbbbbbbbbbbbbbbbbbbbbbbbbbbbbbbbbbbyyyyyyyyyyyyyyyyyyyyyyyyyyyyyyyyyyyyyyyyyyyyyyyyyyyMMMMMMMMMMMMMMMMMMM
kbbbbbbbbbbbbbbbbbbbbbbbbbbbbbbbbbbbbbbbbbbbbbbbbbbbbbbbbbbbbbbbbbbbbyyyyyyyyyyyyyyyyyyyyyyyyyyyyyyyyyyyyyyyyyyyyyyyyyyyyMMMMMMMMMMMMMMMMMM
kbbbbbbbbbbbbbbbbbbbbbbbbbbbbbbbbbbbbbbbbbbbbbbbbbbbbbbbbbbbbbbbbbbbbyyyyyyyyyyyyyyyyyyyyyyyyyyyyyyyyyyyyyyyyyyyyyyyyyyyyMMMMMMMMMMMMMMMMMM
kbbbbbbbbbbbbbbbbbbbbbbbbbbbbbbbbbbbbbbbbbbbbbbbbbbbbbbbbbbbbbbbbbbbbyyyyyyyyyyyyyyyyyyyyyyyyyyyyyyyyyyyyyyyyyyyyyyyyyyyyMMMMMMMMMMMMMMMMMM
kbbbbbbbbbbbbbbbbbbbbbbbbbbbbbbbbbbbbbbbbbbbbbbbbbbbbbbbbbbbbbbbbbbbbyyyyyyyyyyyyyyyyyyyyyyyyyyyyyyyyyyyyyyyyyyyyyyyyyyyyMMMMMMMMMMMMMMMMMM
kbbbbbbbbbbbbbbbbbbbbbbbbbbbbbbbbbbbbbbbbbbbbbbbbbbbbbbbbbbbbbbbbbbbbyyyyyyyyyyyyyyyyyyyyyyyyyyyyyyyyyyyyyyyyyyyyyyyyyyyyyMMMMMMMMMMMMMMMMM
kbbbbbbbbbbbbbbbbbbbbbbbbbbbbbbbbbbbbbbbbbbbbbbbbbbbbbbbbbbbbbbbbbbbbyyyyyyyyyyyyyyyyyyyyyyyyyyyyyyyyyyyyyyyyyyyyyyyyyyyyyMMMMMMMMMMMMMMMMM
kbbbbbbbbbbbbbbbbbbbbbbbbbbbbbbbbbbbbbbbbbbbbbbbbbbbbbbbbbbbbbbbbbbbbyyyyyyyyyyyyyyyyyyyyyyyyyyyyyyyyyyyyyyyyyyyyyyyyyyyyyMMMMMMMMMMMMMMMMM
kbbbbbbbbbbbbbbbbbbbbbbbbbbbbbbbbbbbbbbbbbbbbbbbbbbbbbbbbbbbbbbbbbbbbyyyyyyyyyyyyyyyyyyyyyyyyyyyyyyyyyyyyyyyyyyyyyyyyyyyyyMMMMMMMMMMMMMMMMM
kbbbbbbbbbbbbbbbbbbbbbbbbbbbbbbbbbbbbbbbbbbbbbbbbbbbbbbbbbbbbbbbbbbbbyyyyyyyyyyyyyyyyyyyyyyyyyyyyyyyyyyyyyyyyyyyyyyyyyyyyyyMMMMMMMMMMMMMMMM
kbbbbbbbbbbbbbbbbbbbbbbbbbbbbbbbbbbbbbbbbbbbbbbbbbbbbbbbbbbbbbbbbbbbbyyyyyyyyyyyyyyyyyyyyyyyyyyyyyyyyyyyyyyyyyyyyyyyyyyyyyyMMMMMMMMMMMMMMMM
kbbbbbbbbbbbbbbbbbbbbbbbbbbbbbbbbbbbbbbbbbbbbbbbbbbbbbbbbbbbbbbbbbbbbyyyyyyyyyyyyyyyyyyyyyyyyyyyyyyyyyyyyyyyyyyyyyyyyyyyyyyMMMMMMMMMMMMMMMM
kbbbbbbbbbbbbbbbbbbbbbbbbbbbbbbbbbbbbbbbbbbbbbbbbbbbbbbbbbbbbbbbbbbbbyyyyyyyyyyyyyyyyyyyyyyyyyyyyyyyyyyyyyyyyyyyyyyyyyyyyyyMMMMMMMMMMMMMMMM
kbbbbbbbbbbbbbbbbbbbbbbbbbbbbbbbbbbbbbbbbbbbbbbbbbbbbbbbbbbbbbbbbbbbbyyyyyyyyyyyyyyyyyyyyyyyyyyyyyyyyyyyyyyyyyyyyyyyyyyyyyyMMMMMMMMMMMMMMMM
kbbbbbbbbbbbbbbbbbbbbbbbbbbbbbbbbbbbbbbbbbbbbbbbbbbbbbbbbbbbbbbbbbbbbyyyyyyyyyyyyyyyyyyyyyyyyyyyyyyyyyyyyyyyyyyyyyyyyyyyyyyMMMMMMMMMMMMMMMM
kbbbbbbbbbbbbbbbbbbbbbbbbbbbbbbbbbbbbbbbbbbbbbbbbbbbbbbbbbbbbbbbbbbbbyyyyyyyyyyyyyyyyyyyyyyyyyyyyyyyyyyyyyyyyyyyyyyyyyyyyyyMMMMMMMMMMMMMMMM
kbbbbbbbbbbbbbbbbbbbbbbbbbbbbbbbbbbbbbbbbbbbbbbbbbbbbbbbbbbbbbbbbbbbbyyyyyyyyyyyyyyyyyyyyyyyyyyyyyyyyyyyyyyyyyyyyyyyyyyyyyyMMMMMMMMMMMMMMMM
kbbbbbbbbbbbbbbbbbbbbbbbbbbbbbbbbbbbbbbbbbbbbbbbbbbbbbbbbbbbbbbbbbbbbyyyyyyyyyyyyyyyyyyyyyyyyyyyyyyyyyyyyyyyyyyyyyyyyyyyyyyyMMMMMMMMMMMMMMM
kbbbbbbbbbbbbbbbbbbbbbbbbbbbbbbbbbbbbbbbbbbbbbbbbbbbbbbbbbbbbbbbbbbbbyyyyyyyyyyyyyyyyyyyyyyyyyyyyyyyyyyyyyyyyyyyyyyyyyyyyyyyMMMMMMMMMMMMMMM
kbbbbbbbbbbbbbbbbbbbbbbbbbbbbbbbbbbbbbbbbbbbbbbbbbbbbbbbbbbbbbbbbbbbbyyyyyyyyyyyyyyyyyyyyyyyyyyyyyyyyyyyyyyyyyyyyyyyyyyyyyyyMMMMMMMMMMMMMMM
kbbbbbbbbbbbbbbbbbbbbbbbbbbbbbbbbbbbbbbbbbbbbbbbbbbbbbbbbbbbbbbbbbbbbyyyyyyyyyyyyyyyyyyyyyyyyyyyyyyyyyyyyyyyyyyyyyyyyyyyyyyyMMMMMMMMMMMMMMM
kbbbbbbbbbbbbbbbbbbbbbbbbbbbbbbbbbbbbbbbbbbbbbbbbbbbbbbbbbbbbbbbbbbbbyyyyyyyyyyyyyyyyyyyyyyyyyyyyyyyyyyyyyyyyyyyyyyyyyyyyyyyMMMMMMMMMMMMMMM
kbbbbbbbbbbbbbbbbbbbbbbbbbbbbbbbbbbbbbbbbbbbbbbbbbbbbbbbbbbbbbbbbbbbbyyyyyyyyyyyyyyyyyyyyyyyyyyyyyyyyyyyyyyyyyyyyyyyyyyyyyyyMMMMMMMMMMMMMMM
kbbbbbbbbbbbbbbbbbbbbbbbbbbbbbbbbbbbbbbbbbbbbbbbbbbbbbbbbbbbbbbbbbbbbyyyyyyyyyyyyyyyyyyyyyyyyyyyyyyyyyyyyyyyyyyyyyyyyyyyyyyyMMMMMMMMMMMMMMM
kbbbbbbbbbbbbbbbbbbbbbbbbbbbbbbbbbbbbbbbbbbbbbbbbbbbbbbbbbbbbbbbbbbbbyyyyyyyyyyyyyyyyyyyyyyyyyyyyyyyyyyyyyyyyyyyyyyyyyyyyyyyMMMMMMMMMMMMMMM
kbbbbbbbbbbbbbbbbbbbbbbbbbbbbbbbbbbbbbbbbbbbbbbbbbbbbbbbbbbbbbbbbbbbbyyyyyyyyyyyyyyyyyyyyyyyyyyyyyyyyyyyyyyyyyyyyyyyyyyyyyyyMMMMMMMMMMMMMMM
kbbbbbbbbbbbbbbbbbbbbbbbbbbbbbbbbbbbbbbbbbbbbbbbbbbbbbbbbbbbbbbbbbbbbyyyyyyyyyyyyyyyyyyyyyyyyyyyyyyyyyyyyyyyyyyyyyyyyyyyyyyyMMMMMMMMMMMMMMM
kbbbbbbbbbbbbbbbbbbbbbbbbbbbbbbbbbbbbbbbbbbbbbbbbbbbbbbbbbbbbbbbbbbbbyyyyyyyyyyyyyyyyyyyyyyyyyyyyyyyyyyyyyyyyyyyyyyyyyyyyyyyMMMMMMMMMMMMMMM
kbbbbbbbbbbbbbbbbbbbbbbbbbbbbbbbbbbbbbbbbbbbbbbbbbbbbbbbbbbbbbbbbbbbbyyyyyyyyyyyyyyyyyyyyyyyyyyyyyyyyyyyyyyyyyyyyyyyyyyyyyyyMMMMMMMMMMMMMMM
kbbbbbbbbbbbbbbbbbbbbbbbbbbbbbbbbbbbbbbbbbbbbbbbbbbbbbbbbbbbbbbbbbbbbyyyyyyyyyyyyyyyyyyyyyyyyyyyyyyyyyyyyyyyyyyyyyyyyyyyyyyyMMMMMMMMMMMMMMM
kbbbbbbbbbbbbbbbbbbbbbbbbbbbbbbbbbbbbbbbbbbbbbbbbbbbbbbbbbbbbbbbbbbbbyyyyyyyyyyyyyyyyyyyyyyyyyyyyyyyyyyyyyyyyyyyyyyyyyyyyyyyMMMMMMMMMMMMMMM
kbbbbbbbbbbbbbbbbbbbbbbbbbbbbbbbbbbbbbbbbbbbbbbbbbbbbbbbbbbbbbbbbbbbbyyyyyyyyyyyyyyyyyyyyyyyyyyyyyyyyyyyyyyyyyyyyyyyyyyyyyyyMMMMMMMMMMMMMMM
kbbbbbbbbbbbbbbbbbbbbbbbbbbbbbbbbbbbbbbbbbbbbbbbbbbbbbbbbbbbbbbbbbbbbyyyyyyyyyyyyyyyyyyyyyyyyyyyyyyyyyyyyyyyyyyyyyyyyyyyyyyyMMMMMMMMMMMMMMM
kbbbbbbbbbbbbbbbbbbbbbbbbbbbbbbbbbbbbbbbbbbbbbbbbbbbbbbbbbbbbbbbbbbbbyyyyyyyyyyyyyyyyyyyyyyyyyyyyyyyyyyyyyyyyyyyyyyyyyyyyyyyMMMMMMMMMMMMMMM
kbbbbbbbbbbbbbbbbbbbbbbbbbbbbbbbbbbbbbbbbbbbbbbbbbbbbbbbbbbbbbbbbbbbbyyyyyyyyyyyyyyyyyyyyyyyyyyyyyyyyyyyyyyyyyyyyyyyyyyyyyyyMMMMMMMMMMMMMMM
kbbbbbbbbbbbbbbbbbbbbbbbbbbbbbbbbbbbbbbbbbbbbbbbbbbbbbbbbbbbbbbbbbbbbyyyyyyyyyyyyyyyyyyyyyyyyyyyyyyyyyyyyyyyyyyyyyyyyyyyyyyyMMMMMMMMMMMMMMM
kbbbbbbbbbbbbbbbbbbbbbbbbbbbbbbbbbbbbbbbbbbbbbbbbbbbbbbbbbbbbbbbbbbbbyyyyyyyyyyyyyyyyyyyyyyyyyyyyyyyyyyyyyyyyyyyyyyyyyyyyyyyMMMMMMMMMMMMMMM
kbbbbbbbbbbbbbbbbbbbbbbbbbbbbbbbbbbbbbbbbbbbbbbbbbbbbbbbbbbbbbbbbbbbbyyyyyyyyyyyyyyyyyyyyyyyyyyyyyyyyyyyyyyyyyyyyyyyyyyyyyyyMMMMMMMMMMMMMMM
kbbbbbbbbbbbbbbbbbbbbbbbbbbbbbbbbbbbbbbbbbbbbbbbbbbbbbbbbbbbbbbbbbbbbyyyyyyyyyyyyyyyyyyyyyyyyyyyyyyyyyyyyyyyyyyyyyyyyyyyyyyyMMMMMMMMMMMMMMM
kbbbbbbbbbbbbbbbbbbbbbbbbbbbbbbbbbbbbbbbbbbbbbbbbbbbbbbbbbbbbbbbbbbbbyyyyyyyyyyyyyyyyyyyyyyyyyyyyyyyyyyyyyyyyyyyyyyyyyyyyyyyMMMMMMMMMMMMMMM
kbbbbbbbbbbbbbbbbbbbbbbbbbbbbbbbbbbbbbbbbbbbbbbbbbbbbbbbbbbbbbbbbbbbbyyyyyyyyyyyyyyyyyyyyyyyyyyyyyyyyyyyyyyyyyyyyyyyyyyyyyyyMMMMMMMMMMMMMMM
kbbbbbbbbbbbbbbbbbbbbbbbbbbbbbbbbbbbbbbbbbbbbbbbbbbbbbbbbbbbbbbbbbbbbyyyyyyyyyyyyyyyyyyyyyyyyyyyyyyyyyyyyyyyyyyyyyyyyyyyyyyyMMMMMMMMMMMMMMM
kbbbbbbbbbbbbbbbbbbbbbbbbbbbbbbbbbbbbbbbbbbbbbbbbbbbbbbbbbbbbbbbbbbbbyyyyyyyyyyyyyyyyyyyyyyyyyyyyyyyyyyyyyyyyyyyyyyyyyyyyyyyMMMMMMMMMMMMMMM
kbbbbbbbbbbbbbbbbbbbbbbbbbbbbbbbbbbbbbbbbbbbbbbbbbbbbbbbbbbbbbbbbbbbbyyyyyyyyyyyyyyyyyyyyyyyyyyyyyyyyyyyyyyyyyyyyyyyyyyyyyyyMMMMMMMMMMMMMMM
kbbbbbbbbbbbbbbbbbbbbbbbbbbbbbbbbbbbbbbbbbbbbbbbbbbbbbbbbbbbbbbbbbbbbyyyyyyyyyyyyyyyyyyyyyyyyyyyyyyyyyyyyyyyyyyyyyyyyyyyyyyyMMMMMMMMMMMMMMM
kbbbbbbbbbbbbbbbbbbbbbbbbbbbbbbbbbbbbbbbbbbbbbbbbbbbbbbbbbbbbbbbbbbbbyyyyyyyyyyyyyyyyyyyyyyyyyyyyyyyyyyyyyyyyyyyyyyyyyyyyyyyMMMMMMMMMMMMMMM
kbbbbbbbbbbbbbbbbbbbbbbbbbbbbbbbbbbbbbbbbbbbbbbbbbbbbbbbbbbbbbbbbbbbbyyyyyyyyyyyyyyyyyyyyyyyyyyyyyyyyyyyyyyyyyyyyyyyyyyyyyyyMMMMMMMMMMMMMMM
kbbbbbbbbbbbbbbbbbbbbbbbbbbbbbbbbbbbbbbbbbbbbbbbbbbbbbbbbbbbbbbbbbbbbyyyyyyyyyyyyyyyyyyyyyyyyyyyyyyyyyyyyyyyyyyyyyyyyyyyyyyyMMMMMMMMMMMMMMM
kbbbbbbbbbbbbbbbbbbbbbbbbbbbbbbbbbbbbbbbbbbbbbbbbbbbbbbbbbbbbbbbbbbbbyyyyyyyyyyyyyyyyyyyyyyyyyyyyyyyyyyyyyyyyyyyyyyyyyyyyyyyMMMMMMMMMMMMMMM
kbbbbbbbbbbbbbbbbbbbbbbbbbbbbbbbbbbbbbbbbbbbbbbbbbbbbbbbbbbbbbbbbbbbbyyyyyyyyyyyyyyyyyyyyyyyyyyyyyyyyyyyyyyyyyyyyyyyyyyyyyyyMMMMMMMMMMMMMMM
kbbbbbbbbbbbbbbbbbbbbbbbbbbbbbbbbbbbbbbbbbbbbbbbbbbbbbbbbbbbbbbbbbbbbyyyyyyyyyyyyyyyyyyyyyyyyyyyyyyyyyyyyyyyyyyyyyyyyyyyyyyyMMMMMMMMMMMMMMM
kbbbbbbbbbbbbbbbbbbbbbbbbbbbbbbbbbbbbbbbbbbbbbbbbbbbbbbbbbbbbbbbbbbbbyyyyyyyyyyyyyyyyyyyyyyyyyyyyyyyyyyyyyyyyyyyyyyyyyyyyyyyMMMMMMMMMMMMMMM
kbbbbbbbbbbbbbbbbbbbbbbbbbbbbbbbbbbbbbbbbbbbbbbbbbbbbbbbbbbbbbbbbbbbbyyyyyyyyyyyyyyyyyyyyyyyyyyyyyyyyyyyyyyyyyyyyyyyyyyyyyyyMMMMMMMMMMMMMMM
kbbbbbbbbbbbbbbbbbbbbbbbbbbbbbbbbbbbbbbbbbbbbbbbbbbbbbbbbbbbbbbbbbbbbyyyyyyyyyyyyyyyyyyyyyyyyyyyyyyyyyyyyyyyyyyyyyyyyyyyyyyyMMMMMMMMMMMMMMM
kbbbbbbbbbbbbbbbbbbbbbbbbbbbbbbbbbbbbbbbbbbbbbbbbbbbbbbbbbbbbbbbbbbbbyyyyyyyyyyyyyyyyyyyyyyyyyyyyyyyyyyyyyyyyyyyyyyyyyyyyyyyMMMMMMMMMMMMMMM
mggggggggggggggggggggggggggggggggggggggggggggggggggggggggggggggggggggfffffffffffffffffffffffffffffffffffffffffffffffffffffffooooooooooooooo
mggggggggggggggggggggggggggggggggggggggggggggggggggggggggggggggggggggfffffffffffffffffffffffffffffffffffffffffffffffffffffffooooooooooooooo
mggggggggggggggggggggggggggggggggggggggggggggggggggggggggggggggggggggfffffffffffffffffffffffffffffffffffffffffffffffffffffffooooooooooooooo
mggggggggggggggggggggggggggggggggggggggggggggggggggggggggggggggggggggfffffffffffffffffffffffffffffffffffffffffffffffffffffffooooooooooooooo
mggggggggggggggggggggggggggggggggggggggggggggggggggggggggggggggggggggfffffffffffffffffffffffffffffffffffffffffffffffffffffffooooooooooooooo
mggggggggggggggggggggggggggggggggggggggggggggggggggggggggggggggggggggfffffffffffffffffffffffffffffffffffffffffffffffffffffffooooooooooooooo
mggggggggggggggggggggggggggggggggggggggggggggggggggggggggggggggggggggfffffffffffffffffffffffffffffffffffffffffffffffffffffffooooooooooooooo
mggggggggggggggggggggggggggggggggggggggggggggggggggggggggggggggggggggfffffffffffffffffffffffffffffffffffffffffffffffffffffffooooooooooooooo
mggggggggggggggggggggggggggggggggggggggggggggggggggggggggggggggggggggffffffffffffffffffffffffffffffffffffffffffffffffffffffoooooooooooooooo
mggggggggggggggggggggggggggggggggggggggggggggggggggggggggggggggggggggffffffffffffffffffffffffffffffffffffffffffffffffffffffoooooooooooooooo
mggggggggggggggggggggggggggggggggggggggggggggggggggggggggggggggggggggffffffffffffffffffffffffffffffffffffffffffffffffffffffoooooooooooooooo
mggggggggggggggggggggggggggggggggggggggggggggggggggggggggggggggggggggffffffffffffffffffffffffffffffffffffffffffffffffffffffoooooooooooooooo
mggggggggggggggggggggggggggggggggggggggggggggggggggggggggggggggggggggffffffffffffffffffffffffffffffffffffffffffffffffffffffoooooooooooooooo
mggggggggggggggggggggggggggggggggggggggggggggggggggggggggggggggggggggffffffffffffffffffffffffffffffffffffffffffffffffffffffoooooooooooooooo
mggggggggggggggggggggggggggggggggggggggggggggggggggggggggggggggggggggffffffffffffffffffffffffffffffffffffffffffffffffffffffoooooooooooooooo
mggggggggggggggggggggggggggggggggggggggggggggggggggggggggggggggggggggfffffffffffffffffffffffffffffffffffffffffffffffffffffffooooooooooooooo
mggggggggggggggggggggggggggggggggggggggggggggggggggggggggggggggggggggfffffffffffffffffffffffffffffffffffffffffffffffffffffffooooooooooooooo
mggggggggggggggggggggggggggggggggggggggggggggggggggggggggggggggggggggfffffffffffffffffffffffffffffffffffffffffffffffffffffffooooooooooooooo
mggggggggggggggggggggggggggggggggggggggggggggggggggggggggggggggggggggfffffffffffffffffffffffffffffffffffffffffffffffffffffffooooooooooooooo
mggggggggggggggggggggggggggggggggggggggggggggggggggggggggggggggggggggfffffffffffffffffffffffffffffffffffffffffffffffffffffffooooooooooooooo
tzzzzggggggggggggggggggggggggggggggggggggggggggggggggggggggggggggggggfffffffffffffffffffffffffffffffffffffffffffffffffffffffooooooooooooooo
tzzzzzzzzggggggggggggggggggggggggggggggggggggggggggggggggggggggggggggfffffffffffffffffffffffffffffffffffffffffffffffffffffffooooooooooooooo
tzzzzzzzzzzggggggggggggggggggggggggggggggggggggggggggggggggggggggggggfffffffffffffffffffffffffffffffffffffffffffffffffffffffooooooooooooooo
tzzzzzzzzzzzzggggggggggggggggggggggggggggggggggggggggggggggggggggggggffffffffffffffffffffffffffffffffffffffffffffffffffffffoooooooooooooooo
tzzzzzzzzzzzzzzzgggggggggggggggggggggggggggggggggggggggggggggggggggggffffffffffffffffffffffffffffffffffffffffffffffffffffffoooooooooooooooo
tzzzzzzzzzzzzzzzzggggggggggggggggggggggggggggggggggggggggggggggggggggffffffffffffffffffffffffffffffffffffffffffffffffffffffoooooooooooooooo
tzzzzzzzzzzzzzzzzggggggggggggggggggggggggggggggggggggggggggggggggggggffffffffffffffffffffffffffffffffffffffffffffffffffffffoooooooooooooooo
tzzzzzzzzzzzzzzzzzgggggggggggggggggggggggggggggggggggggggggggggggggggffffffffffffffffffffffffffffffffffffffffffffffffffffffoooooooooooooooo
tzzzzzzzzzzzzzzzzzzggggggggggggggggggggggggggggggggggggggggggggggggggffffffffffffffffffffffffffffffffffffffffffffffffffffffoooooooooooooooo
tzzzzzzzzzzzzzzzzzzzgggggggggggggggggggggggggggggggggggggggggggggggggffffffffffffffffffffffffffffffffffffffffffffffffffffffoooooooooooooooo
tzzzzzzzzzzzzzzzzzzzzggggggggggggggggggggggggggggggggggggggggggggggggfffffffffffffffffffffffffffffffffffffffffffffffffffffooooooooooooooooo
tzzzzzzzzzzzzzzzzzzzzzgggggggggggggggggggggggggggggggggggggggggggggggffffffffffffffffffffffffffffffffffffffffffffffffffffoooooooooooooooooo
tzzzzzzzzzzzzzzzzzzzzzzzgggggggggggggggggggggggggggggggggggggggggggggffffffffffffffffffffffffffffffffffffffffffffffffffffoooooooooooooooooo
tzzzzzzzzzzzzzzzzzzzzzzzzzgggggggggggggggggggggggggggggggggggggggggggfffffffffffffffffffffffffffffffffffffffffffffffffffooooooooooooooooooo
tzzzzzzzzzzzzzzzzzzzzzzzzzzzgggggggggggggggggggggggggggggggggggggggggfffffffffffffffffffffffffffffffffffffffffffffffffffooooooooooooooooooo
tTzzzzzzzzzzzzzzzzzzzzzzzzzzzzgggggggggggggggggggggggggggggggggggggggffffffffffffffffffffffffffffffffffffffffffffffffffoooooooooooooooooooo
tTzzzzzzzzzzzzzzzzzzzzzzzzzzzzzzzzgggggggggggggggggggggggggggggggggggffffffffffffffffffffffffffffffffffffffffffffffffffoooooooooooooooooooo
tTzzzzzzzzzzzzzzzzzzzzzzzzzzzzzzzzzzzggggggggggggggggggggggggggggggggfffffffffffffffffffffffffffffffffffffffffffffffffooooooooooooooooooooo
tTzzzzzzzzzzzzzzzzzzzzzzzzzzzzzzzzzzzzzzzzgggggggggggggggggggggggggggffffffffffffffffffffffffffffffffffffffffffffffffoooooooooooooooooooooo
tTzzzzzzzzzzzzzzzzzzzzzzzzzzzzzzzzzzzzzzzzzzzzzzzzzzzzzggggggggggggggfffffffffffffffffffffffffffffffffffffffffffffffooooooooooooooooooooooo
tTzzzzzzzzzzzzzzzzzzzzzzzzzzzzzzzzzzzzzzzzzzzzzzzzzzzzzzzzzzzzzzzzzzzjjjjjjjjjjjjjjjjjjjjjjjfjfjfjjjjjjjjjjjooooooooooooooooooooooooooooooo
tTzzzzzzzzzzzzzzzzzzzzzzzzzzzzzzzzzzzzzzzzzzzzzzzzzzzzzzzzzzzzzzzzzzzjjjjjjjjjjjjjjjjjjjjjjjjjjjjjjjjjjjjjjjooooooooooooooooooooooooooooooo
tTzzzzzzzzzzzzzzzzzzzzzzzzzzzzzzzzzzzzzzzzzzzzzzzzzzzzzzzzzzzzzzzzzzzjjjjjjjjjjjjjjjjjjjjjjjjjjjjjjjjjjjjjjoooooooooooooooooooooooooooooooo
tTzzzzzzzzzzzzzzzzzzzzzzzzzzzzzzzzzzzzzzzzzzzzzzzDDDDDDDDDDDDDDDDDDDDssssssssssssssssssssjjjjjjjjjjjjjjjjjjoooooooooooooooooooooooooooooooo
tTzzzzzzzzzzzzzzzzzzzzzzzzzzzzzzzzzzzzzzzzzzzzzzzDDDDDDDDDDDDDDDDDDDDssssssssssssssssssssjjjjjjjjjjjjjjjjjjoooooooooooooooooooooooooooooooo
tTzzzzzzzzzzzzzzzzzzzzzzzzzzzzzzzzzzzzzzzzzzzzzzzDDDDDDDDDDDDDDDDDDDDssssssssssssssssssssjjjjjjjjjjjjjjjjjooooooooooooooooooooooooooooooooo
tTTzzzzzzzzzzzzzzzzzzzzzzzzzzzzzzzzzzzzzzzzzzzzzzDDDDDDDDDDDDDDDDDDDDssssssssssssssssssssjjjjjjjjjjjjjjjjjooooooooooooooooooooooooooooooooo
tTTzzzzzzzzzzzzzzzzzzzzzzzzzzzzzzzzzzzzzzzzzzzzzzDDDDDDDDDDDDDDDDDDDDssssssssssssssssssssjjjjjjjjjjjjjjjjjooooooooooooooooooooooooooooooooo
tTTzzzzzzzzzzzzzzzzzzzzzzzzzzzzzzzzzzzzzzzzzzzzzzDDDDDDDDDDDDDDDDDDDDssssssssssssssssssssjjjjjjjjjjjjjjjjoooooooooooooooooooooooooooooooooo
tTTzzzzzzzzzzzzzzzzzzzzzzzzzzzzzzzzzzzzzzzzzzzzzzDDDDDDDDDDDDDDDDDDDDssssssssssssssssssssjjjjjjjjjjjjjjjjoooooooooooooooooooooooooooooooooo
tTTTzzzzzzzzzzzzzzzzzzzzzzzzzzzzzzzzzzzzzzzzzzzzzDDDDDDDDDDDDDDDDDDDDssssssssssssssssssssjjjjjjjjjjjjjjjjoooooooooooooooooooooooooooooooooo
tTTTTTzzzzzzzzzzzzzzzzzzzzzzzzzzzzzzzzzzzzzzzzzzzDDDDDDDDDDDDDDDDDDDDssssssssssssssssssssjjjjjjjjjjjjjjjooooooooooooooooooooooooooooooooooo
tTTTTTTTTzzzzzzzzzzzzzzzzzzzzzzzzzzzzzzzzzzzzzzzzDDDDDDDDDDDDDDDDrEDDssGSssssssssssssssssjjjjjjjjjjjjjjjooooooooooooooooooooooooooooooooooo
tTTTTTTTTTTTTTzzzzzzzzzzzzzzzzzzzzzzzzzzzzzzzzzzzDDDDDDDDDDDDDDDDeKDDssUwssssssssssssssssjjjjjjjjjjjjjjjooooooooooooooooooooooooooooooooooo
tTTTTTTTTTTTTTTTTTTTTTTTTTTzzzzzzzzzzzzzzzzzzzzzzDDDDDDDDDDDDDDDDeKDDssUwssssssssssssssssjjjjjjjjjjjjjjoooooooooooooooooooooooooooooooooooo
tTTTTTTTTTTTTTTTTTTTTTTTTTTTTTzzzzzzzzzzzzzzzzzzzDDDDDDDDDDDDDDDDeKDDssUwssssssssssssssssjjjjjjjjjjjjjjoooooooooooooooooooooooooooooooooooo
tTTTTTTTTTTTTTTTTTTTTTTTTTTTTTTTTzzzzzzzzzzzzzzzzDDDDDDDDDDDDDDDDDDDDssssssssssssssssssssjjjjjjjjjjjjjooooooooooooooooooooooooooooooooooooo
tTTTTTTTTTTTTTTTTTTTTTTTTTTTTTTTTTzzzzzzzzzzzzzzzDDDDDDDDDDDDDDDDDDDDssssssssssssssssssssjjjjjjjjjjjjjooooooooooooooooooooooooooooooooooooo
tTTTTTTTTTTTTTTTTTTTTTTTTTTTTTTTTTTTzzzzzzzzzzzzzDDDDDDDDDDDDDDDDDDDDssssssssssssssssssssjjjjjjjjjjjjoooooooooooooooooooooooooooooooooooooo
tTTTTTTTTTTTTTTTTTTTTTTTTTTTTTTTTTTTTTzzzzzzzzzzzDDDDDDDDDDDDDDDDDDDDssssssssssssssssssssjjjjjjjjjjjooooooooooooooooooooooooooooooooooooooo
tTTTTTTTTTTTTTTTTTTTTTTTTTTTTTTTTTTTTTTTzzzzzzzzzDDDDDDDDDDDDDDDDDDDDssssssssssssssssssssjjjjjjjjjjoooooooooooooooooooooooooooooooooooooooo
tTTTTTTTTTTTTTTTTTTTTTTTTTTTTTTTTTTTTTTTTTTzzzzzzDDDDDDDDDDDDDDDDDDDDssssssssssssssssssssjjjjjjjjjooooooooooooooooooooooooooooooooooooooooo
tTTTTTTTTTTTTTTTTTTTTTTTTTTTTTTTTTTTTTTTTTTzzzzzzDDDDDDDDDDDDDDDDDDDDssssssssssssssssssssjjjjjjjjoooooooooooooooooooooooooooooooooooooooooo
tTTTTTTTTTTTTTTTTTTTTTTTTTTTTTTTTTTTTTTTTTTTzzzzzDDDDDDDDDDDDDDDDDDDDssssssssssssssssssssjjjjjjjooooooooooooooooooooooooooooooooooooooooooo
tTTTTTTTTTTTTTTTTTTTTTTTTTTTTTTTTTTTTTTTTTTTzzzzzDDDDDDDDDDDDDDDDDDDDssssssssssssssssssssjjjjjjoooooooooooooooooooooooooooooooooooooooooooo
tTTTTTTTTTTTTTTTTTTTTTTTTTTTTTTTTTTTTTTTTTTTTzzzzzzzzzzzzzzzzzzzzzzzzjjjjjjjjjjjjjjjjjjjjjjjjjooooooooooooooooooooooooooooooooooooooooooooo
tTTTTTTTTTTTTTTTTTTTTTTTTTTTTTTTTTTTTTTTTTTTTTzzzzzzzzzzzzzzzzzzzzzzzjjjjjjjjjjjjjjjjjjjjjjjooooooooooooooooooooooooooooooooooooooooooooooo
tTTTTTTTTTTTTTTTTTTTTTTTTTTTTTTTTTTTTTTTTTTTTTTTTTTTTTTTTTTTTTTTTTTTToooooooooooooooooooooooooooooooooooooooooooooooooooooooooooooooooooooo
tttttttttttttttttttttttttttttttttttttttttttttttttttttttttttttttttttttCCCCCCCCCCCCCCCCCCCCCCCCCCCCCCCCCCCCCCCCCCCCCCCCCCCCCCCCCCCCCCCCCCCCCC
"}
