"a" = (/turf/unsimulated/wall/planetary/athena,/area/odysseybase/level3/nw)
"b" = (/turf/simulated/open/athena,/area/odysseybase/level3/nw/open)
"f" = (/turf/simulated/open/athena,/area/odysseybase/level3/se/open)
"g" = (/turf/simulated/open/athena,/area/odysseybase/level3/sw/open)
"j" = (/turf/simulated/floor/outdoors/newdirt_nograss/athena,/area/odysseybase/level3/se)
"k" = (/turf/unsimulated/wall/planetary/normal/athena,/area/odysseybase/level3/nw/open)
"m" = (/turf/unsimulated/wall/planetary/normal/athena,/area/odysseybase/level3/sw/open)
"n" = (/turf/simulated/mineral/athena,/area/odysseybase/level3/nw)
"o" = (/turf/simulated/mineral/athena,/area/odysseybase/level3/se)
"r" = (/obj/structure/railing/grey{dir = 1},/obj/structure/railing/grey{dir = 8},/turf/simulated/open/athena,/area/odysseybase/level3/landingpad)
"t" = (/turf/unsimulated/wall/planetary/athena,/area/odysseybase/level3/sw)
"w" = (/obj/effect/landmark/map_data/odysseybase,/turf/unsimulated/wall/planetary/athena,/area/odysseybase/level3/sw)
"x" = (/turf/unsimulated/wall/planetary/athena,/area/odysseybase/level3/ne)
"y" = (/turf/simulated/open/athena,/area/odysseybase/level3/ne/open)
"z" = (/turf/simulated/floor/outdoors/newdirt_nograss/athena,/area/odysseybase/level3/sw)
"B" = (/turf/unsimulated/wall/planetary/normal/athena,/area/odysseybase/level3/ne/open)
"C" = (/turf/unsimulated/wall/planetary/athena,/area/odysseybase/level3/se)
"D" = (/turf/simulated/floor/outdoors/sidewalk/slab/athena,/area/odysseybase/level3/landingpad)
"E" = (/obj/structure/railing/grey{dir = 1},/obj/structure/railing/grey{dir = 4},/turf/simulated/open/athena,/area/odysseybase/level3/landingpad)
"G" = (/obj/structure/railing/grey{dir = 8},/obj/structure/railing/grey{dir = 1},/turf/simulated/open/athena,/area/odysseybase/level3/landingpad)
"K" = (/obj/structure/railing/grey{dir = 4},/turf/simulated/open/athena,/area/odysseybase/level3/landingpad)
"M" = (/turf/simulated/mineral/athena,/area/odysseybase/level3/ne)
"R" = (/turf/simulated/floor/reinforced/athena,/area/odysseybase/level3/ne/open)
"S" = (/obj/structure/railing/grey{dir = 4},/obj/structure/railing/grey{dir = 1},/turf/simulated/open/athena,/area/odysseybase/level3/landingpad)
"T" = (/turf/simulated/mineral/athena,/area/odysseybase/level3/sw)
"U" = (/obj/structure/railing/grey{dir = 8},/turf/simulated/open/athena,/area/odysseybase/level3/landingpad)

(1,1,1) = {"
aaaaaaaaaaaaaaaaaaaaaaaaaaaaaaaaaakkkkkkkkkkkkkkkkkkkkkkkkkkkkkkkkkkkBBBBBBBBBBBBBBBBBBBBBBBBBBBBBBBBBBBBBBBBBBBBxxxxxxxxxxxxxxxxxxxxxxxxxx
annnnnnnnnnnnnnnnnnnnnnnnnnnnnnnnnbbbbbbbbbbbbbbbbbbbbbbbbbbbbbbbbbbbyyyyyyyyyyyyyyyyyyyyyyyyyyyyyyyyyyyyyyyyyyyyMMMMMMMMMMMMMMMMMMMMMMMMMM
annnnnnnnnnnnnnnnnnnnnnnnnnnnnnnbbbbbbbbbbbbbbbbbbbbbbbbbbbbbbbbbbbbbyyyyyyyyyyyyyyyyyyyyyyyyyyyyyyyyyyyyyyyyyyyyMMMMMMMMMMMMMMMMMMMMMMMMMM
annnnnnnnnnnnnnnnnnnnnnnnnnnnnbbbbbbbbbbbbbbbbbbbbbbbbbbbbbbbbbbbbbbbyyyyyyyyyyyyyyyyyyyyyyyyyyyyyyyyyyyyyyyyyyyyyMMMMMMMMMMMMMMMMMMMMMMMMM
annnnnnnnnnnnnnnnnnnnnnnnnnnbbbbbbbbbbbbbbbbbbbbbbbbbbbbbbbbbbbbbbbbbyyyyyyyyyyyyyyyyyyyyyyyyyyyyyyyyyyyyyyyyyyyyyyMMMMMMMMMMMMMMMMMMMMMMMM
annnnnnnnnnnnnnnnnnnnnnnnnnbbbbbbbbbbbbbbbbbbbbbbbbbbbbbbbbbbbbbbbbbbyyyyyyyyyyyyyyyyyyyyyyyyyyyyyyyyyyyyyyyyyyyyyyMMMMMMMMMMMMMMMMMMMMMMMM
annnnnnnnnnnnnnnnnnnnnnnnbbbbbbbbbbbbbbbbbbbbbbbbbbbbbbbbbbbbbbbbbbbbyyyyyyyyyyyyyyyyyyyyyyyyyyyyyyyyyyyyyyyyyyyyyyyMMMMMMMMMMMMMMMMMMMMMMM
annnnnnnnnnnnnnnnnnnnnnnbbbbbbbbbbbbbbbbbbbbbbbbbbbbbbbbbbbbbbbbbbbbbyyyyyyyyyyyyyyyyyyyyyyyyyyyyyyyyyyyyyyyyyyyyyyyyMMMMMMMMMMMMMMMMMMMMMM
annnnnnnnnnnnnnnnnnnnnnbbbbbbbbbbbbbbbbbbbbbbbbbbbbbbbbbbbbbbbbbbbbbbyyyyyyyyyyyyyyyyyyyyyyyyyyyyyyyyyyyyyyyyyyyyyyyyMMMMMMMMMMMMMMMMMMMMMM
annnnnnnnnnnnnnnnnnnnbbbbbbbbbbbbbbbbbbbbbbbbbbbbbbbbbbbbbbbbbbbbbbbbyyyyyyyyyyyyyyyyyyyyyyyyyyyyyyyyyyyyyyyyyyyyyyyyMMMMMMMMMMMMMMMMMMMMMM
annnnnnnnnnnnnnnnbbbbbbbbbbbbbbbbbbbbbbbbbbbbbbbbbbbbbbbbbbbbbbbbbbbbyyyyyyyyyyyyyyyyyyyyyyyyyyyyyyyyyyyyyyyyyyyyyyyyyMMMMMMMMMMMMMMMMMMMMM
annnnnnnnnnnbbbbbbbbbbbbbbbbbbbbbbbbbbbbbbbbbbbbbbbbbbbbbbbbbbbbbbbbbyyyyyyyyyyyyyyyyyyyyyyyyyyyyyyyyyyyyyyyyyyyyyyyyyMMMMMMMMMMMMMMMMMMMMM
annnnbbbbbbbbbbbbbbbbbbbbbbbbbbbbbbbbbbbbbbbbbbbbbbbbbbbbbbbbbbbbbbbbyyyyyyyyyyyyyyyyyyyyyyyyyyyyyyyyyyyyyyyyyyyyyyyyyyMMMMMMMMMMMMMMMMMMMM
annbbbbbbbbbbbbbbbbbbbbbbbbbbbbbbbbbbbbbbbbbbbbbbbbbbbbbbbbbbbbbbbbbbyyyyyyyyyyyyyyyyyyyyyyyyyyyyyyyyyyyyyyyyyyyyyyyyyyMMMMMMMMMMMMMMMMMMMM
anbbbbbbbbbbbbbbbbbbbbbbbbbbbbbbbbbbbbbbbbbbbbbbbbbbbbbbbbbbbbbbbbbbbyyyyyyyyyyyyyyyyyyyyyyyyyyyyyyyyyyyyyyyyyyyyyyyyyyyMMMMMMMMMMMMMMMMMMM
kbbbbbbbbbbbbbbbbbbbbbbbbbbbbbbbbbbbbbbbbbbbbbbbbbbbbbbbbbbbbbbbbbbbbyyyyyyyyyyyyyyyyyyyyyyyyyyyyyyyyyyyyyyyyyyyyyyyyyyyMMMMMMMMMMMMMMMMMMM
kbbbbbbbbbbbbbbbbbbbbbbbbbbbbbbbbbbbbbbbbbbbbbbbbbbbbbbbbbbbbbbbbbbbbyyyyyyyyyyyyyyyyyyyyyyyyyyyyyyyyyyyyyyyyyyyyyyyyyyyMMMMMMMMMMMMMMMMMMM
kbbbbbbbbbbbbbbbbbbbbbbbbbbbbbbbbbbbbbbbbbbbbbbbbbbbbbbbbbbbbbbbbbbbbyyyyyyyyyyyyyyyyyyyyyyyyyyyyyyyyyyyyyyyyyyyyyyyyyyyyMMMMMMMMMMMMMMMMMM
kbbbbbbbbbbbbbbbbbbbbbbbbbbbbbbbbbbbbbbbbbbbbbbbbbbbbbbbbbbbbbbbbbbbbyyyyyyyyyyyyyyyyyyyyyyyyyyyyyyyyyyyyyyyyyyyyyyyyyyyyMMMMMMMMMMMMMMMMMM
kbbbbbbbbbbbbbbbbbbbbbbbbbbbbbbbbbbbbbbbbbbbbbbbbbbbbbbbbbbbbbbbbbbbbyyyyyyyyyyyyyyyyyyyyyyyyyyyyyyyyyyyyyyyyyyyyyyyyyyyyMMMMMMMMMMMMMMMMMM
kbbbbbbbbbbbbbbbbbbbbbbbbbbbbbbbbbbbbbbbbbbbbbbbbbbbbbbbbbbbbbbbbbbbbyyyyyyyyyyyyyyyyyyyyyyyyyyyyyyyyyyyyyyyyyyyyyyyyyyyyMMMMMMMMMMMMMMMMMM
kbbbbbbbbbbbbbbbbbbbbbbbbbbbbbbbbbbbbbbbbbbbbbbbbbbbbbbbbbbbbbbbbbbbbyyyyyyyyyyyyyyyyyyyyyyyyyyyyyyyyyyyyyyyyyyyyyyyyyyyyyMMMMMMMMMMMMMMMMM
kbbbbbbbbbbbbbbbbbbbbbbbbbbbbbbbbbbbbbbbbbbbbbbbbbbbbbbbbbbbbbbbbbbbbyyyyyyyyyyyyyyyyyyyyyyyyyyyyyyyyyyyyyyyyyyyyyyyyyyyyyMMMMMMMMMMMMMMMMM
kbbbbbbbbbbbbbbbbbbbbbbbbbbbbbbbbbbbbbbbbbbbbbbbbbbbbbbbbbbbbbbbbbbbbyyyyyyyyyyyyyyyyyyyyyyyyyyyRRRRRRRRRRRRRRRRRRRRRRRRyyMMMMMMMMMMMMMMMMM
kbbbbbbbbbbbbbbbbbbbbbbbbbbbbbbbbbbbbbbbbbbbbbbbbbbbbbbbbbbbbbbbbbbbbyyyyyyyyyyyyyyyyyyyyyyyyyyyRRRRRRRRRRRRRRRRRRRRRRRRyyMMMMMMMMMMMMMMMMM
kbbbbbbbbbbbbbbbbbbbbbbbbbbbbbbbbbbbbbbbbbbbbbbbbbbbbbbbbbbbbbbbbbbbbyyyyyyyyyyyyyyyyyyyyyyyyyyyRRRRRRRRRRRRRRRRRRRRRRRRyyyMMMMMMMMMMMMMMMM
kbbbbbbbbbbbbbbbbbbbbbbbbbbbbbbbbbbbbbbbbbbbbbbbbbbbbbbbbbbbbbbbbbbbbyyyyyyyyyyyyyyyyyyyyyyyyyyyRRRRRRRRRRRRRRRRRRRRRRRRyyyMMMMMMMMMMMMMMMM
kbbbbbbbbbbbbbbbbbbbbbbbbbbbbbbbbbbbbbbbbbbbbbbbbbbbbbbbbbbbbbbbbbbbbyyyyyyyyyyyyyyyyyyyyyyyyyyyRRRRRRRRRRRRRRRRRRRRRRRRRyyMMMMMMMMMMMMMMMM
kbbbbbbbbbbbbbbbbbbbbbbbbbbbbbbbbbbbbbbbbbbbbbbbbbbbbbbbbbbbbbbbbbbbbyyyyyyyyyyyyyyyyyyyyyyyyyyyRRRRRRRRRRRRRRRRRRRRRRRRRyyMMMMMMMMMMMMMMMM
kbbbbbbbbbbbbbbbbbbbbbbbbbbbbbbbbbbbbbbbbbbbbbbbbbbbbbbbbbbbbbbbbbbbbyyyyyyyyyyyyyyyyyyyyyyyyyyyRRRRRRRRRRRRRRRRRRRRRRRRRyyMMMMMMMMMMMMMMMM
kbbbbbbbbbbbbbbbbbbbbbbbbbbbbbbbbbbbbbbbbbbbbbbbbbbbbbbbbbbbbbbbbbbbbyyyyyyyyyyyyyyyyyyyyyyyyyyyRRRRRRRRRRRRRRRRRRRRRRRRRyyMMMMMMMMMMMMMMMM
kbbbbbbbbbbbbbbbbbbbbbbbbbbbbbbbbbbbbbbbbbbbbbbbbbbbbbbbbbbbbbbbbbbbbyyyyyyyyyyyyyyyyyyyyyyyyyyyRRRRRRRRRRRRRRRRRRRRRRRRRyyMMMMMMMMMMMMMMMM
kbbbbbbbbbbbbbbbbbbbbbbbbbbbbbbbbbbbbbbbbbbbbbbbbbbbbbbbbbbbbbbbbbbbbyyyyyyyyyyyyyyyyyyyyyyyyyyyRRRRRRRRRRRRRRRRRRRRRRRRyyyMMMMMMMMMMMMMMMM
kbbbbbbbbbbbbbbbbbbbbbbbbbbbbbbbbbbbbbbbbbbbbbbbbbbbbbbbbbbbbbbbbbbbbyyyyyyyyyyyyyyyyyyyyyyyyyyyRRRRRRRRRRRRRRRRRRRRRRRRyyyyMMMMMMMMMMMMMMM
kbbbbbbbbbbbbbbbbbbbbbbbbbbbbbbbbbbbbbbbbbbbbbbbbbbbbbbbbbbbbbbbbbbbbyyyyyyyyyyyyyyyyyyyyyyyyyyyRRRRRRRRRRRRRRRRRRRRRRRRyyyyMMMMMMMMMMMMMMM
kbbbbbbbbbbbbbbbbbbbbbbbbbbbbbbbbbbbbbbbbbbbbbbbbbbbbbbbbbbbbbbbbbbbbyyyyyyyyyyyyyyyyyyyyyyyyyyyRRRRRRRRRRRRRRRRRRRRRRRRyyyyMMMMMMMMMMMMMMM
kbbbbbbbbbbbbbbbbbbbbbbbbbbbbbbbbbbbbbbbbbbbbbbbbbbbbbbbbbbbbbbbbbbbbyyyyyyyyyyyyyyyyyyyyyyyyyyRRRRRRRRRRRRRRRRRRRRRRRRRyyyyMMMMMMMMMMMMMMM
kbbbbbbbbbbbbbbbbbbbbbbbbbbbbbbbbbbbbbbbbbbbbbbbbbbbbbbbbbbbbbbbbbbbbyyyyyyyyyyyyyyyyyyyyyyyRRRRRRRRRRRRRRRRRRRRRRRRRRRRyyyyMMMMMMMMMMMMMMM
kbbbbbbbbbbbbbbbbbbbbbbbbbbbbbbbbbbbbbbbbbbbbbbbbbbbbbbbbbbbbbbbbbbbbyyyyyyyyyyyyyyyyyyyyyyyRRRRRRRRRRRRRRRRRRRRRRRRRRRRyyyyMMMMMMMMMMMMMMM
kbbbbbbbbbbbbbbbbbbbbbbbbbbbbbbbbbbbbbbbbbbbbbbbbbbbbbbbbbbbbbbbbbbbbyyyyyyyyyyyyyyyyyyyyyyyRRRRRRRRRRRRRRRRRRRRRRRRRRRRyyyyMMMMMMMMMMMMMMM
kbbbbbbbbbbbbbbbbbbbbbbbbbbbbbbbbbbbbbbbbbbbbbbbbbbbbbbbbbbbbbbbbbbbbyyyyyyyyyyyyyyyyyyyyyyyRRRRRRRRRRRRyyyyyyyyyyyyyyyyyyyyMMMMMMMMMMMMMMM
kbbbbbbbbbbbbbbbbbbbbbbbbbbbbbbbbbbbbbbbbbbbbbbbbbbbbbbbbbbbbbbbbbbbbyyyyyyyyyyyyyyyyyyyyyyyyyyyyyyyyyyyyyyyyyyyyyyyyyyyyyyyMMMMMMMMMMMMMMM
kbbbbbbbbbbbbbbbbbbbbbbbbbbbbbbbbbbbbbbbbbbbbbbbbbbbbbbbbbbbbbbbbbbbbyyyyyyyyyyyyyyyyyyyyyyyyyyyyyyyyyyyyyyyyyyyyyyyyyyyyyyyMMMMMMMMMMMMMMM
kbbbbbbbbbbbbbbbbbbbbbbbbbbbbbbbbbbbbbbbbbbbbbbbbbbbbbbbbbbbbbbbbbbbbyyyyyyyyyyyyyyyyyyyyyyyyyyyyyyyyyyyyyyyyyyyyyyyyyyyyyyyMMMMMMMMMMMMMMM
kbbbbbbbbbbbbbbbbbbbbbbbbbbbbbbbbbbbbbbbbbbbbbbbbbbbbbbbbbbbbbbbbbbbbyyyyyyyyyyyyyyyyyyyyyyyyyyyyyyyyyyyyyyyyyyyyyyyyyyyyyyyMMMMMMMMMMMMMMM
kbbbbbbbbbbbbbbbbbbbbbbbbbbbbbbbbbbbbbbbbbbbbbbbbbbbbbbbbbbbbbbbbbbbbyyyyyyyyyyyyyyyyyyyyyyyyyyyyyyyyyyyyyyyyyyyyyyyyyyyyyyyMMMMMMMMMMMMMMM
kbbbbbbbbbbbbbbbbbbbbbbbbbbbbbbbbbbbbbbbbbbbbbbbbbbbbbbbbbbbbbbbbbbbbyyyyyyyyyyyyyyyyyyyyyyyyyyyyyyyyyyyyyyyyyyyyyyyyyyyyyyyMMMMMMMMMMMMMMM
kbbbbbbbbbbbbbbbbbbbbbbbbbbbbbbbbbbbbbbbbbbbbbbbbbbbbbbbbbbbbbbbbbbbbyyyyyyyyyyyyyyyyyyyyyyyyyyyyyyyyyyyyyyyyyyyyyyyyyyyyyyyMMMMMMMMMMMMMMM
kbbbbbbbbbbbbbbbbbbbbbbbbbbbbbbbbbbbbbbbbbbbbbbbbbbbbbbbbbbbbbbbbbbbbyyyyyyyyyyyyyyyyyyyyyyyyyyyyyyyyyyyyyyyyyyyyyyyyyyyyyyyMMMMMMMMMMMMMMM
kbbbbbbbbbbbbbbbbbbbbbbbbbbbbbbbbbbbbbbbbbbbbbbbbbbbbbbbbbbbbbbbbbbbbyyyyyyyyyyyyyyyyyyyyyyyyyyyyyyyyyyyyyyyyyyyyyyyyyyyyyyyMMMMMMMMMMMMMMM
kbbbbbbbbbbbbbbbbbbbbbbbbbbbbbbbbbbbbbbbbbbbbbbbbbbbbbbbbbbbbbbbbbbbbyyyyyyyyyyyyyyyyyyyyyyyyyyyyyyyyyyyyyyyyyyyyyyyyyyyyyyyMMMMMMMMMMMMMMM
kbbbbbbbbbbbbbbbbbbbbbbbbbbbbbbbbbbbbbbbbbbbbbbbbbbbbbbbbbbbbbbbbbbbbyyyyyyyyyyyyyyyyyyyyyyyyyyyyyyyyyyyyyyyyyyyyyyyyyyyyyyyMMMMMMMMMMMMMMM
kbbbbbbbbbbbbbbbbbbbbbbbbbbbbbbbbbbbbbbbbbbbbbbbbbbbbbbbbbbbbbbbbbbbbyyyyyyyyyyyyyyyyyyyyyyyyyyyyyyyyyyyyyyyyyyyyyyyyyyyyyyyMMMMMMMMMMMMMMM
kbbbbbbbbbbbbbbbbbbbbbbbbbbbbbbbbbbbbbbbbbbbbbbbbbbbbbbbbbbbbbbbbbbbbyyyyyyyyyyyyyyyyyyyyyyyyyyyyyyyyyyyyyyyyyyyyyyyyyyyyyyyMMMMMMMMMMMMMMM
kbbbbbbbbbbbbbbbbbbbbbbbbbbbbbbbbbbbbbbbbbbbbbbbbbbbbbbbbbbbbbbbbbbbbyyyyyyyyyyyyyyyyyyyyyyyyyyyyyyyyyyyyyyyyyyyyyyyyyyyyyyyMMMMMMMMMMMMMMM
kbbbbbbbbbbbbbbbbbbbbbbbbbbbbbbbbbbbbbbbbbbbbbbbbbbbbbbbbbbbbbbbbbbbbyyyyyyyyyyyyyyyyyyyyyyyyyyyyyyyyyyyyyyyyyyyyyyyyyyyyyyyMMMMMMMMMMMMMMM
kbbbbbbbbbbbbbbbbbbbbbbbbbbbbbbbbbbbbbbbbbbbbbbbbbbbbbbbbbbbbbbbbbbbbyyyyyyyyyyyyyyyyyyyyyyyyyyyyyyyyyyyyyyyyyyyyyyyyyyyyyyyMMMMMMMMMMMMMMM
kbbbbbbbbbbbbbbbbbbbbbbbbbbbbbbbbbbbbbbbbbbbbbbbbbbbbbbbbbbbbbbbbbbbbyyyyyyyyyyyyyyyyyyyyyyyyyyyyyyyyyyyyyyyyyyyyyyyyyyyyyyyMMMMMMMMMMMMMMM
kbbbbbbbbbbbbbbbbbbbbbbbbbbbbbbbbbbbbbbbbbbbbbbbbbbbbbbbbbbbbbbbbbbbbyyyyyyyyyyyyyyyyyyyyyyyyyyyyyyyyyyyyyyyyyyyyyyyyyyyyyyyMMMMMMMMMMMMMMM
kbbbbbbbbbbbbbbbbbbbbbbbbbbbbbbbbbbbbbbbbbbbbbbbbbbbbbbbbbbbbbbbbbbbbyyyyyyyyyyyyyyyyyyyyyyyyyyyyyyyyyyyyyyyyyyyyyyyyyyyyyyyMMMMMMMMMMMMMMM
kbbbbbbbbbbbbbbbbbbbbbbbbbbbbbbbbbbbbbbbbbbbbbbbbbbbbbbbbbbbbbbbbbbbbyyyyyyyyyyyyyyyyyyyyyyyyyyyyyyyyyyyyyyyyyyyyyyyyyyyyyyyMMMMMMMMMMMMMMM
kbbbbbbbbbbbbbbbbbbbbbbbbbbbbbbbbbbbbbbbbbbbbbbbbbbbbbbbbbbbbbbbbbbbbyyyyyyyyyyyyyyyyyyyyyyyyyyyyyyyyyyyyyyyyyyyyyyyyyyyyyyyMMMMMMMMMMMMMMM
kbbbbbbbbbbbbbbbbbbbbbbbbbbbbbbbbbbbbbbbbbbbbbbbbbbbbbbbbbbbbbbbbbbbbyyyyyyyyyyyyyyyyyyyyyyyyyyyyyyyyyyyyyyyyyyyyyyyyyyyyyyyMMMMMMMMMMMMMMM
kbbbbbbbbbbbbbbbbbbbbbbbbbbbbbbbbbbbbbbbbbbbbbbbbbbbbbbbbbbbbbbbbbbbbyyyyyyyyyyyyyyyyyyyyyyyyyyyyyyyyyyyyyyyyyyyyyyyyyyyyyyyMMMMMMMMMMMMMMM
kbbbbbbbbbbbbbbbbbbbbbbbbbbbbbbbbbbbbbbbbbbbbbbbbbbbbbbbbbbbbbbbbbbbbyyyyyyyyyyyyyyyyyyyyyyyyyyyyyyyyyyyyyyyyyyyyyyyyyyyyyyyMMMMMMMMMMMMMMM
kbbbbbbbbbbbbbbbbbbbbbbbbbbbbbbbbbbbbbbbbbbbbbbbbbbbbbbbbbbbbbbbbbbbbyyyyyyyyyyyyyyyyyyyyyyyyyyyyyyyyyyyyyyyyyyyyyyyyyyyyyyyMMMMMMMMMMMMMMM
kbbbbbbbbbbbbbbbbbbbbbbbbbbbbbbbbbbbbbbbbbbbbbbbbbbbbbbbbbbbbbbbbbbbbyyyyyyyyyyyyyyyyyyyyyyyyyyyyyyyyyyyyyyyyyyyyyyyyyyyyyyyMMMMMMMMMMMMMMM
kbbbbbbbbbbbbbbbbbbbbbbbbbbbbbbbbbbbbbbbbbbbbbbbbbbbbbbbbbbbbbbbbbbbbyyyyyyyyyyyyyyyyyyyyyyyyyyyyyyyyyyyyyyyyyyyyyyyyyyyyyyyMMMMMMMMMMMMMMM
kbbbbbbbbbbbbbbbbbbbbbbbbbbbbbbbbbbbbbbbbbbbbbbbbbbbbbbbbbbbbbbbbbbbbyyyyyyyyyyyyyyyyyyyyyyyyyyyyyyyyyyyyyyyyyyyyyyyyyyyyyyyMMMMMMMMMMMMMMM
kbbbbbbbbbbbbbbbbbbbbbbbbbbbbbbbbbbbbbbbbbbbbbbbbbbbbbbbbbbbbbbbbbbbbyyyyyyyyyyyyyyyyyyyyyyyyyyyyyyyyyyyyyyyyyyyyyyyyyyyyyyyMMMMMMMMMMMMMMM
kbbbbbbbbbbbbbbbbbbbbbbbbbbbbbbbbbbbbbbbbbbbbbbbbbbbbbbbbbbbbbbbbbbbbyyyyyyyyyyyyyyyyyyyyyyyyyyyyyyyyyyyyyyyyyyyyyyyyyyyyyyyMMMMMMMMMMMMMMM
mggggggggggggggggggggggggggggggggggggggggggggggggggggggggggggggggggggfffffffffffffffffffffffffffffffffffffffffffffffffffffffooooooooooooooo
mggggggggggggggggggggggggggggggggggggggggggggggggggggggggggggggggggggfffffffffffffffffffffffffffffffffffffffffffffffffffffffooooooooooooooo
mggggggggggggggggggggggggggggggggggggggggggggggggggggggggggggggggggggfffffffffffffffffffffffffffffffffffffffffffffffffffffffooooooooooooooo
mggggggggggggggggggggggggggggggggggggggggggggggggggggggggggggggggggggfffffffffffffffffffffffffffffffffffffffffffffffffffffffooooooooooooooo
mggggggggggggggggggggggggggggggggggggggggggggggggggggggggggggggggggggfffffffffffffffffffffffffffffffffffffffffffffffffffffffooooooooooooooo
mggggggggggggggggggggggggggggggggggggggggggggggggggggggggggggggggggggfffffffffffffffffffffffffffffffffffffffffffffffffffffffooooooooooooooo
mggggggggggggggggggggggggggggggggggggggggggggggggggggggggggggggggggggfffffffffffffffffffffffffffffffffffffffffffffffffffffffooooooooooooooo
mggggggggggggggggggggggggggggggggggggggggggggggggggggggggggggggggggggfffffffffffffffffffffffffffffffffffffffffffffffffffffffooooooooooooooo
mggggggggggggggggggggggggggggggggggggggggggggggggggggggggggggggggggggffffffffffffffffffffffffffffffffffffffffffffffffffffffoooooooooooooooo
mggggggggggggggggggggggggggggggggggggggggggggggggggggggggggggggggggggffffffffffffffffffffffffffffffffffffffffffffffffffffffoooooooooooooooo
mggggggggggggggggggggggggggggggggggggggggggggggggggggggggggggggggggggffffffffffffffffffffffffffffffffffffffffffffffffffffffoooooooooooooooo
mggggggggggggggggggggggggggggggggggggggggggggggggggggggggggggggggggggffffffffffffffffffffffffffffffffffffffffffffffffffffffoooooooooooooooo
mggggggggggggggggggggggggggggggggggggggggggggggggggggggggggggggggggggffffffffffffffffffffffffffffffffffffffffffffffffffffffoooooooooooooooo
mggggggggggggggggggggggggggggggggggggggggggggggggggggggggggggggggggggffffffffffffffffffffffffffffffffffffffffffffffffffffffoooooooooooooooo
mggggggggggggggggggggggggggggggggggggggggggggggggggggggggggggggggggggffffffffffffffffffffffffffffffffffffffffffffffffffffffoooooooooooooooo
mggggggggggggggggggggggggggggggggggggggggggggggggggggggggggggggggggggfffffffffffffffffffffffffffffffffffffffffffffffffffffffooooooooooooooo
mggggggggggggggggggggggggggggggggggggggggggggggggggggggggggggggggggggfffffffffffffffffffffffffffffffffffffffffffffffffffffffooooooooooooooo
mggggggggggggggggggggggggggggggggggggggggggggggggggggggggggggggggggggfffffffffffffffffffffffffffffffffffffffffffffffffffffffooooooooooooooo
mggggggggggggggggggggggggggggggggggggggggggggggggggggggggggggggggggggfffffffffffffffffffffffffffffffffffffffffffffffffffffffooooooooooooooo
mggggggggggggggggggggggggggggggggggggggggggggggggggggggggggggggggggggfffffffffffffffffffffffffffffffffffffffffffffffffffffffooooooooooooooo
tzzzzggggggggggggggggggggggggggggggggggggggggggggggggggggggggggggggggfffffffffffffffffffffffffffffffffffffffffffffffffffffffooooooooooooooo
tzzzzzzzzggggggggggggggggggggggggggggggggggggggggggggggggggggggggggggfffffffffffffffffffffffffffffffffffffffffffffffffffffffooooooooooooooo
tzzzzzzzzzzggggggggggggggggggggggggggggggggggggggggggggggggggggggggggfffffffffffffffffffffffffffffffffffffffffffffffffffffffooooooooooooooo
tzzzzzzzzzzzzggggggggggggggggggggggggggggggggggggggggggggggggggggggggffffffffffffffffffffffffffffffffffffffffffffffffffffffoooooooooooooooo
tzzzzzzzzzzzzzzzgggggggggggggggggggggggggggggggggggggggggggggggggggggffffffffffffffffffffffffffffffffffffffffffffffffffffffoooooooooooooooo
tzzzzzzzzzzzzzzzzggggggggggggggggggggggggggggggggggggggggggggggggggggffffffffffffffffffffffffffffffffffffffffffffffffffffffoooooooooooooooo
tzzzzzzzzzzzzzzzzggggggggggggggggggggggggggggggggggggggggggggggggggggffffffffffffffffffffffffffffffffffffffffffffffffffffffoooooooooooooooo
tzzzzzzzzzzzzzzzzzgggggggggggggggggggggggggggggggggggggggggggggggggggffffffffffffffffffffffffffffffffffffffffffffffffffffffoooooooooooooooo
tzzzzzzzzzzzzzzzzzzggggggggggggggggggggggggggggggggggggggggggggggggggffffffffffffffffffffffffffffffffffffffffffffffffffffffoooooooooooooooo
tzzzzzzzzzzzzzzzzzzzgggggggggggggggggggggggggggggggggggggggggggggggggffffffffffffffffffffffffffffffffffffffffffffffffffffffoooooooooooooooo
tzzzzzzzzzzzzzzzzzzzzggggggggggggggggggggggggggggggggggggggggggggggggfffffffffffffffffffffffffffffffffffffffffffffffffffffooooooooooooooooo
tzzzzzzzzzzzzzzzzzzzzzgggggggggggggggggggggggggggggggggggggggggggggggffffffffffffffffffffffffffffffffffffffffffffffffffffoooooooooooooooooo
tzzzzzzzzzzzzzzzzzzzzzzzgggggggggggggggggggggggggggggggggggggggggggggffffffffffffffffffffffffffffffffffffffffffffffffffffoooooooooooooooooo
tzzzzzzzzzzzzzzzzzzzzzzzzzgggggggggggggggggggggggggggggggggggggggggggfffffffffffffffffffffffffffffffffffffffffffffffffffooooooooooooooooooo
tzzzzzzzzzzzzzzzzzzzzzzzzzzzgggggggggggggggggggggggggggggggggggggggggfffffffffffffffffffffffffffffffffffffffffffffffffffooooooooooooooooooo
tTzzzzzzzzzzzzzzzzzzzzzzzzzzzzgggggggggggggggggggggggggggggggggggggggffffffffffffffffffffffffffffffffffffffffffffffffffoooooooooooooooooooo
tTzzzzzzzzzzzzzzzzzzzzzzzzzzzzzzzzgggggggggggggggggggggggggggggggggggffffffffffffffffffffffffffffffffffffffffffffffffffoooooooooooooooooooo
tTzzzzzzzzzzzzzzzzzzzzzzzzzzzzzzzzzzzggggggggggggggggggggggggggggggggfffffffffffffffffffffffffffffffffffffffffffffffffooooooooooooooooooooo
tTzzzzzzzzzzzzzzzzzzzzzzzzzzzzzzzzzzzzzzzzgggggggggggggggggggggggggggffffffffffffffffffffffffffffffffffffffffffffffffoooooooooooooooooooooo
tTzzzzzzzzzzzzzzzzzzzzzzzzzzzzzzzzzzzzzzzzzzzzzzzzzzzzzggggggggggggggfffffffffffffffffffffffffffffffffffffffffffffffooooooooooooooooooooooo
tTzzzzzzzzzzzzzzzzzzzzzzzzzzzzzzzzzzzzzzzzzzzzzzzzzzzzzzzzzzzzzzzzzzzjjjjjjjjjjjjjjjjjjjjjjjfjfjfjjjjjjjjjjjooooooooooooooooooooooooooooooo
tTzzzzzzzzzzzzzzzzzzzzzzzzzzzzzzzzzzzzzzzzzzzzzzzzzzzzzzzzzzzzzzzzzzzjjjjjjjjjjjjjjjjjjjjjjjjjjjjjjjjjjjjjjjooooooooooooooooooooooooooooooo
tTzzzzzzzzzzzzzzzzzzzzzzzzzzzzzzzzzzzzzzzzzzzzzzzzzzzzzzzzzzzzzzzzzzzjjjjjjjjjjjjjjjjjjjjjjjjjjjjjjjjjjjjjjoooooooooooooooooooooooooooooooo
tTzzzzzzzzzzzzzzzzzzzzzzzzzzzzzzzzzzzzzzzzzzzzzzzDDDDDDDDDDDDDDDDDDDDDDDDDDDDDDDDDDDDDDDDjjjjjjjjjjjjjjjjjjoooooooooooooooooooooooooooooooo
tTzzzzzzzzzzzzzzzzzzzzzzzzzzzzzzzzzzzzzzzzzzzzzzzDDDDDDDDDDDDDDDDDDDDDDDDDDDDDDDDDDDDDDDDjjjjjjjjjjjjjjjjjjoooooooooooooooooooooooooooooooo
tTzzzzzzzzzzzzzzzzzzzzzzzzzzzzzzzzzzzzzzzzzzzzzzzDDDDDDDDDDDDDDDDDDDDDDDDDDDDDDDDDDDDDDDDjjjjjjjjjjjjjjjjjooooooooooooooooooooooooooooooooo
tTTzzzzzzzzzzzzzzzzzzzzzzzzzzzzzzzzzzzzzzzzzzzzzzDDDDDDDDDDDDDDDDDDDDDDDDDDDDDDDDDDDDDDDDjjjjjjjjjjjjjjjjjooooooooooooooooooooooooooooooooo
tTTzzzzzzzzzzzzzzzzzzzzzzzzzzzzzzzzzzzzzzzzzzzzzzDDDDDDDDDDDDDDDDDDDDDDDDDDDDDDDDDDDDDDDDjjjjjjjjjjjjjjjjjooooooooooooooooooooooooooooooooo
tTTzzzzzzzzzzzzzzzzzzzzzzzzzzzzzzzzzzzzzzzzzzzzzzDDDDDDDDDDDDDDDDDDDDDDDDDDDDDDDDDDDDDDDDjjjjjjjjjjjjjjjjoooooooooooooooooooooooooooooooooo
tTTzzzzzzzzzzzzzzzzzzzzzzzzzzzzzzzzzzzzzzzzzzzzzzDDDDDDDDDDDDDDDDDDDDDDDDDDDDDDDDDDDDDDDDjjjjjjjjjjjjjjjjoooooooooooooooooooooooooooooooooo
tTTTzzzzzzzzzzzzzzzzzzzzzzzzzzzzzzzzzzzzzzzzzzzzzDDDDDDDDDDDDDDDDDDDDDDDDDDDDDDDDDDDDDDDDjjjjjjjjjjjjjjjjoooooooooooooooooooooooooooooooooo
tTTTTTzzzzzzzzzzzzzzzzzzzzzzzzzzzzzzzzzzzzzzzzzzzDDDDDDDDDDDDDDDDDDDDDDDDDDDDDDDDDDDDDDDDjjjjjjjjjjjjjjjooooooooooooooooooooooooooooooooooo
tTTTTTTTTzzzzzzzzzzzzzzzzzzzzzzzzzzzzzzzzzzzzzzzzDDDDDDDDDDDDDDDDrEDDDDGSDDDDDDDDDDDDDDDDjjjjjjjjjjjjjjjooooooooooooooooooooooooooooooooooo
tTTTTTTTTTTTTTzzzzzzzzzzzzzzzzzzzzzzzzzzzzzzzzzzzDDDDDDDDDDDDDDDDUKDDDDUKDDDDDDDDDDDDDDDDjjjjjjjjjjjjjjjooooooooooooooooooooooooooooooooooo
tTTTTTTTTTTTTTTTTTTTTTTTTTTzzzzzzzzzzzzzzzzzzzzzzDDDDDDDDDDDDDDDDUKDDDDUKDDDDDDDDDDDDDDDDjjjjjjjjjjjjjjoooooooooooooooooooooooooooooooooooo
tTTTTTTTTTTTTTTTTTTTTTTTTTTTTTzzzzzzzzzzzzzzzzzzzDDDDDDDDDDDDDDDDUKDDDDUKDDDDDDDDDDDDDDDDjjjjjjjjjjjjjjoooooooooooooooooooooooooooooooooooo
tTTTTTTTTTTTTTTTTTTTTTTTTTTTTTTTTzzzzzzzzzzzzzzzzDDDDDDDDDDDDDDDDDDDDDDDDDDDDDDDDDDDDDDDDjjjjjjjjjjjjjooooooooooooooooooooooooooooooooooooo
tTTTTTTTTTTTTTTTTTTTTTTTTTTTTTTTTTzzzzzzzzzzzzzzzDDDDDDDDDDDDDDDDDDDDDDDDDDDDDDDDDDDDDDDDjjjjjjjjjjjjjooooooooooooooooooooooooooooooooooooo
tTTTTTTTTTTTTTTTTTTTTTTTTTTTTTTTTTTTzzzzzzzzzzzzzDDDDDDDDDDDDDDDDDDDDDDDDDDDDDDDDDDDDDDDDjjjjjjjjjjjjoooooooooooooooooooooooooooooooooooooo
tTTTTTTTTTTTTTTTTTTTTTTTTTTTTTTTTTTTTTzzzzzzzzzzzDDDDDDDDDDDDDDDDDDDDDDDDDDDDDDDDDDDDDDDDjjjjjjjjjjjooooooooooooooooooooooooooooooooooooooo
tTTTTTTTTTTTTTTTTTTTTTTTTTTTTTTTTTTTTTTTzzzzzzzzzDDDDDDDDDDDDDDDDDDDDDDDDDDDDDDDDDDDDDDDDjjjjjjjjjjoooooooooooooooooooooooooooooooooooooooo
tTTTTTTTTTTTTTTTTTTTTTTTTTTTTTTTTTTTTTTTTTTzzzzzzDDDDDDDDDDDDDDDDDDDDDDDDDDDDDDDDDDDDDDDDjjjjjjjjjooooooooooooooooooooooooooooooooooooooooo
tTTTTTTTTTTTTTTTTTTTTTTTTTTTTTTTTTTTTTTTTTTzzzzzzDDDDDDDDDDDDDDDDDDDDDDDDDDDDDDDDDDDDDDDDjjjjjjjjoooooooooooooooooooooooooooooooooooooooooo
tTTTTTTTTTTTTTTTTTTTTTTTTTTTTTTTTTTTTTTTTTTTzzzzzDDDDDDDDDDDDDDDDDDDDDDDDDDDDDDDDDDDDDDDDjjjjjjjooooooooooooooooooooooooooooooooooooooooooo
tTTTTTTTTTTTTTTTTTTTTTTTTTTTTTTTTTTTTTTTTTTTzzzzzDDDDDDDDDDDDDDDDDDDDDDDDDDDDDDDDDDDDDDDDjjjjjjoooooooooooooooooooooooooooooooooooooooooooo
tTTTTTTTTTTTTTTTTTTTTTTTTTTTTTTTTTTTTTTTTTTTTzzzzzzzzzzzzzzzzzzzzzzzzjjjjjjjjjjjjjjjjjjjjjjjjjooooooooooooooooooooooooooooooooooooooooooooo
tTTTTTTTTTTTTTTTTTTTTTTTTTTTTTTTTTTTTTTTTTTTTTzzzzzzzzzzzzzzzzzzzzzzzjjjjjjjjjjjjjjjjjjjjjjjooooooooooooooooooooooooooooooooooooooooooooooo
tTTTTTTTTTTTTTTTTTTTTTTTTTTTTTTTTTTTTTTTTTTTTTTTTTTTTTTTTTTTTTTTTTTTToooooooooooooooooooooooooooooooooooooooooooooooooooooooooooooooooooooo
wttttttttttttttttttttttttttttttttttttttttttttttttttttttttttttttttttttCCCCCCCCCCCCCCCCCCCCCCCCCCCCCCCCCCCCCCCCCCCCCCCCCCCCCCCCCCCCCCCCCCCCCC
"}
