"a" = (/turf/unsimulated/wall/planetary/athena,/area/odysseybase/level3/nw)
"b" = (/turf/simulated/open/athena,/area/odysseybase/level3/nw/open)
"e" = (/turf/simulated/wall/r_wall,/area/odysseybase/level3/ne/open)
"f" = (/turf/simulated/open/athena,/area/odysseybase/level3/se/open)
"g" = (/turf/simulated/open/athena,/area/odysseybase/level3/sw/open)
"i" = (/obj/structure/railing{dir = 1},/turf/simulated/open/athena,/area/odysseybase/level3/ne/open)
"j" = (/turf/simulated/floor/outdoors/newdirt_nograss/athena,/area/odysseybase/level3/se)
"k" = (/turf/unsimulated/wall/planetary/normal/athena,/area/odysseybase/level3/nw/open)
"m" = (/turf/unsimulated/wall/planetary/normal/athena,/area/odysseybase/level3/sw/open)
"n" = (/turf/simulated/mineral/athena,/area/odysseybase/level3/nw)
"o" = (/turf/simulated/mineral/athena,/area/odysseybase/level3/se)
"p" = (/obj/structure/ladder,/obj/effect/floor_decal/industrial/hatch/yellow,/turf/simulated/floor/reinforced/athena,/area/odysseybase/level3/ne/open)
"r" = (/obj/structure/railing/grey{dir = 1},/obj/structure/railing/grey{dir = 8},/turf/simulated/open/athena,/area/odysseybase/level3/landingpad)
"t" = (/turf/unsimulated/wall/planetary/athena,/area/odysseybase/level3/sw)
"w" = (/obj/effect/landmark/map_data/odysseybase,/turf/unsimulated/wall/planetary/athena,/area/odysseybase/level3/sw)
"x" = (/turf/unsimulated/wall/planetary/athena,/area/odysseybase/level3/ne)
"y" = (/turf/simulated/open/athena,/area/odysseybase/level3/ne/open)
"z" = (/turf/simulated/floor/outdoors/newdirt_nograss/athena,/area/odysseybase/level3/sw)
"B" = (/turf/unsimulated/wall/planetary/normal/athena,/area/odysseybase/level3/ne/open)
"C" = (/turf/unsimulated/wall/planetary/athena,/area/odysseybase/level3/se)
"D" = (/turf/simulated/floor/outdoors/sidewalk/slab/athena,/area/odysseybase/level3/landingpad)
"E" = (/obj/structure/railing/grey{dir = 1},/obj/structure/railing/grey{dir = 4},/turf/simulated/open/athena,/area/odysseybase/level3/landingpad)
"G" = (/obj/structure/railing/grey{dir = 8},/obj/structure/railing/grey{dir = 1},/turf/simulated/open/athena,/area/odysseybase/level3/landingpad)
"K" = (/obj/structure/railing/grey{dir = 4},/turf/simulated/open/athena,/area/odysseybase/level3/landingpad)
"M" = (/turf/simulated/mineral/athena,/area/odysseybase/level3/ne)
"N" = (/obj/structure/railing,/turf/simulated/open/athena,/area/odysseybase/level3/ne/open)
"Q" = (/obj/structure/railing{dir = 4},/turf/simulated/open/athena,/area/odysseybase/level3/ne/open)
"R" = (/turf/simulated/floor/reinforced/athena,/area/odysseybase/level3/ne/open)
"S" = (/obj/structure/railing/grey{dir = 4},/obj/structure/railing/grey{dir = 1},/turf/simulated/open/athena,/area/odysseybase/level3/landingpad)
"T" = (/turf/simulated/mineral/athena,/area/odysseybase/level3/sw)
"U" = (/obj/structure/railing/grey{dir = 8},/turf/simulated/open/athena,/area/odysseybase/level3/landingpad)

(1,1,1) = {"
aaaaaaaaaaaaaaaaaaaaaaaaaaaaaaaaaakkkkkkkkkkkkkkkkkkkkkkkkkkkkkkkkkkkBBBBBBBBBBBBBBBBBBBBBBBBBBBBBBBBBBBBBBBBBBBBxxxxxxxxxxxxxxxxxxxxxxxxxxx
annnnnnnnnnnnnnnnnnnnnnnnnnnnnnnnnbbbbbbbbbbbbbbbbbbbbbbbbbbbbbbbbbbbyyyyyyyyyyyyyyyyyyyyyyyyyyyyyyyyyyyyyyyyyyyyMMMMMMMMMMMMMMMMMMMMMMMMMMx
annnnnnnnnnnnnnnnnnnnnnnnnnnnnnnbbbbbbbbbbbbbbbbbbbbbbbbbbbbbbbbbbbbbyyyyyyyyyyyyyyyyyyyyyyyyyyyyyyyyyyyyyyyyyyyyMMMMMMMMMMMMMMMMMMMMMMMMMMx
annnnnnnnnnnnnnnnnnnnnnnnnnnnnbbbbbbbbbbbbbbbbbbbbbbbbbbbbbbbbbbbbbbbyyyyyyyyyyyyyyyyyyyyyyyyyyyyyyyyyyyyyyyyyyyyyMMMMMMMMMMMMMMMMMMMMMMMMMx
annnnnnnnnnnnnnnnnnnnnnnnnnnbbbbbbbbbbbbbbbbbbbbbbbbbbbbbbbbbbbbbbbbbyyyyyyyyyyyyyyyyyyyyyyyyyyyyyyyyyyyyyyyyyyyyyyyMMMMMMMMMMMMMMMMMMMMMMMx
annnnnnnnnnnnnnnnnnnnnnnnnnbbbbbbbbbbbbbbbbbbbbbbbbbbbbbbbbbbbbbbbbbbyyyyyyyyyyyyyyyyyyyyyyyyyyyyyyyyyyyyyyyyyyyyyyyyyyMMMMMMMMMMMMMMMMMMMMx
annnnnnnnnnnnnnnnnnnnnnnnbbbbbbbbbbbbbbbbbbbbbbbbbbbbbbbbbbbbbbbbbbbbyyyyyyyyyyyyyyyyyyyyyyyyyyyyyyyyyyyyyyyyyyyyyyyyyyyyMMMMMMMMMMMMMMMMMMx
annnnnnnnnnnnnnnnnnnnnnnbbbbbbbbbbbbbbbbbbbbbbbbbbbbbbbbbbbbbbbbbbbbbyyyyyyyyyyyyyyyyyyyyyyyyyyyyyyyyyyyyyyyyyyyyyyyyyyyyyyyyMMMMMMMMMMMMMMx
annnnnnnnnnnnnnnnnnnnnnbbbbbbbbbbbbbbbbbbbbbbbbbbbbbbbbbbbbbbbbbbbbbbyyyyyyyyyyyyyyyyyyyyyyyyyyyyyyyyyyyyyyyyyyyyyyyyyyyyyyyyyMMMMMMMMMMMMMx
annnnnnnnnnnnnnnnnnnnbbbbbbbbbbbbbbbbbbbbbbbbbbbbbbbbbbbbbbbbbbbbbbbbyyyyyyyyyyyyyyyyyyyyyyyyyyyyyyyyyyyyyyyyyyyyyyyyyyyyyyyyyMMMMMMMMMMMMMx
annnnnnnnnnnnnnnnbbbbbbbbbbbbbbbbbbbbbbbbbbbbbbbbbbbbbbbbbbbbbbbbbbbbyyyyyyyyyyyyyyyyyyyyyyyyyyyyyyyyyyyyyyyyyyyyyyyyyyyyyyyyyyMMMMMMMMMMMMx
annnnnnnnnnnbbbbbbbbbbbbbbbbbbbbbbbbbbbbbbbbbbbbbbbbbbbbbbbbbbbbbbbbbyyyyyyyyyyyyyyyyyyyyyyyyyyyyyyyyyyyyyyyyyyyyyyyyyyyyyyyyyyMMMMMMMMMMMMx
annnnbbbbbbbbbbbbbbbbbbbbbbbbbbbbbbbbbbbbbbbbbbbbbbbbbbbbbbbbbbbbbbbbyyyyyyyyyyyyyyyyyyyyyyyyyyyyyyyyyyyyyyyyyyyyyyyyyyyyyyyyyyMMMMMMMMMMMMx
annbbbbbbbbbbbbbbbbbbbbbbbbbbbbbbbbbbbbbbbbbbbbbbbbbbbbbbbbbbbbbbbbbbyyyyyyyyyyyyyyyyyyyyyyyyyyyyyyyyyyyyyyyyyyyyyyyyyyyyyyyyyyMMMMMMMMMMMMx
anbbbbbbbbbbbbbbbbbbbbbbbbbbbbbbbbbbbbbbbbbbbbbbbbbbbbbbbbbbbbbbbbbbbyyyyyyyyyyyyyyyyyyyyyyyyyyyyyyyyyyyyyyyyyyyyyyyyyyyyyyyyyyyMMMMMMMMMMMx
kbbbbbbbbbbbbbbbbbbbbbbbbbbbbbbbbbbbbbbbbbbbbbbbbbbbbbbbbbbbbbbbbbbbbyyyyyyyyyyyyyyyyyyyyyyyyyyyyyyyyyyyyyyyyyyyyyyyyyyyyyyyyyyyMMMMMMMMMMMx
kbbbbbbbbbbbbbbbbbbbbbbbbbbbbbbbbbbbbbbbbbbbbbbbbbbbbbbbbbbbbbbbbbbbbyyyyyyyyyyyyyyyyyyyyyyyyyyyyyyyyyyyyyyyyyyNRRRRRRRRRRRRRRyyMMMMMMMMMMMx
kbbbbbbbbbbbbbbbbbbbbbbbbbbbbbbbbbbbbbbbbbbbbbbbbbbbbbbbbbbbbbbbbbbbbyyyyyyyyyyyyyyyyyyyyyyyyyyyyyyyyyyyyyyyyyQpRRRRRRRRRRRRRRyyMMMMMMMMMMMx
kbbbbbbbbbbbbbbbbbbbbbbbbbbbbbbbbbbbbbbbbbbbbbbbbbbbbbbbbbbbbbbbbbbbbyyyyyyyyyyyyyyyyyyyyyyyyyyyyyyyyyyyyyyyyyyiRRRRRRRRRRRRRRyyMMMMMMMMMMMx
kbbbbbbbbbbbbbbbbbbbbbbbbbbbbbbbbbbbbbbbbbbbbbbbbbbbbbbbbbbbbbbbbbbbbyyyyyyyyyyyyyyyyyyyyyyyyyyyyyyyyyyyyyyRRRRRRRRRRRRRRRRRRRyyMMMMMMMMMMMx
kbbbbbbbbbbbbbbbbbbbbbbbbbbbbbbbbbbbbbbbbbbbbbbbbbbbbbbbbbbbbbbbbbbbbyyyyyyyyyyyyyyyyyyyyyyyyyyyyyyyyyyyyyyRRRRRRRRRRRRRRReeeeeyMMMMMMMMMMMx
kbbbbbbbbbbbbbbbbbbbbbbbbbbbbbbbbbbbbbbbbbbbbbbbbbbbbbbbbbbbbbbbbbbbbyyyyyyyyyyyyyyyyyyyyyyyyyyyyyyyyyyyyyyRRRRRRRRRRRRRRReeeeeyMMMMMMMMMMMx
kbbbbbbbbbbbbbbbbbbbbbbbbbbbbbbbbbbbbbbbbbbbbbbbbbbbbbbbbbbbbbbbbbbbbyyyyyyyyyyyyyyyyyyyyyyyyyyyyyyyyyyyyyyRRRRRRRRRRRRRRReeeeeyMMMMMMMMMMMx
kbbbbbbbbbbbbbbbbbbbbbbbbbbbbbbbbbbbbbbbbbbbbbbbbbbbbbbbbbbbbbbbbbbbbyyyyyyyyyyyyyyyyyyyyyyyyyyyyyyyyyyyyyyRRRRRRRRRRRRRRReeeeeyMMMMMMMMMMMx
kbbbbbbbbbbbbbbbbbbbbbbbbbbbbbbbbbbbbbbbbbbbbbbbbbbbbbbbbbbbbbbbbbbbbyyyyyyyyyyyyyyyyyyyyyyyyyyyyyyyyyyyyyyRRRRRRRRRRRRRRReeeeeyMMMMMMMMMMMx
kbbbbbbbbbbbbbbbbbbbbbbbbbbbbbbbbbbbbbbbbbbbbbbbbbbbbbbbbbbbbbbbbbbbbyyyyyyyyyyyyyyyyyyyyyyyyyyyyyyyyyyyyyyRRRRRRRRRRRRRRRRRRRyyMMMMMMMMMMMx
kbbbbbbbbbbbbbbbbbbbbbbbbbbbbbbbbbbbbbbbbbbbbbbbbbbbbbbbbbbbbbbbbbbbbyyyyyyyyyyyyyyyyyyyyyyyyyyyyyyyyyyyRRRRRRRRRRRRRRRRRRRRRRyyMMMMMMMMMMMx
kbbbbbbbbbbbbbbbbbbbbbbbbbbbbbbbbbbbbbbbbbbbbbbbbbbbbbbbbbbbbbbbbbbbbyyyyyyyyyyyyyyyyyyyyyyyyyyyyyyyyyyyRRRRRRRRRRRRRRRRRRRRRRyyMMMMMMMMMMMx
kbbbbbbbbbbbbbbbbbbbbbbbbbbbbbbbbbbbbbbbbbbbbbbbbbbbbbbbbbbbbbbbbbbbbyyyyyyyyyyyyyyyyyyyyyyyyyyyyyyyyyyyRRRRRRRRRRRRRRRRRRRRRRyyMMMMMMMMMMMx
kbbbbbbbbbbbbbbbbbbbbbbbbbbbbbbbbbbbbbbbbbbbbbbbbbbbbbbbbbbbbbbbbbbbbyyyyyyyyyyyyyyyyyyyyyyyyyyyyyyyyyyyRRRRRRRRRRRRyyyyyyyyyyyyMMMMMMMMMMMx
kbbbbbbbbbbbbbbbbbbbbbbbbbbbbbbbbbbbbbbbbbbbbbbbbbbbbbbbbbbbbbbbbbbbbyyyyyyyyyyyyyyyyyyyyyyyyyyyyyyyyyyyyyyyyyyyyyyyyyyyyyyyyyyyMMMMMMMMMMMx
kbbbbbbbbbbbbbbbbbbbbbbbbbbbbbbbbbbbbbbbbbbbbbbbbbbbbbbbbbbbbbbbbbbbbyyyyyyyyyyyyyyyyyyyyyyyyyyyyyyyyyyyyyyyyyyyyyyyyyyyyyyyyyyyMMMMMMMMMMMx
kbbbbbbbbbbbbbbbbbbbbbbbbbbbbbbbbbbbbbbbbbbbbbbbbbbbbbbbbbbbbbbbbbbbbyyyyyyyyyyyyyyyyyyyyyyyyyyyyyyyyyyyyyyyyyyyyyyyyyyyyyyyyyyyMMMMMMMMMMMx
kbbbbbbbbbbbbbbbbbbbbbbbbbbbbbbbbbbbbbbbbbbbbbbbbbbbbbbbbbbbbbbbbbbbbyyyyyyyyyyyyyyyyyyyyyyyyyyyyyyyyyyyyyyyyyyyyyyyyyyyyyyyyyyyMMMMMMMMMMMx
kbbbbbbbbbbbbbbbbbbbbbbbbbbbbbbbbbbbbbbbbbbbbbbbbbbbbbbbbbbbbbbbbbbbbyyyyyyyyyyyyyyyyyyyyyyyyyyyyyyyyyyyyyyyyyyyyyyyyyyyyyyyyyyyMMMMMMMMMMMx
kbbbbbbbbbbbbbbbbbbbbbbbbbbbbbbbbbbbbbbbbbbbbbbbbbbbbbbbbbbbbbbbbbbbbyyyyyyyyyyyyyyyyyyyyyyyyyyyyyyyyyyyyyyyyyyyyyyyyyyyyyyyyyyyMMMMMMMMMMMx
kbbbbbbbbbbbbbbbbbbbbbbbbbbbbbbbbbbbbbbbbbbbbbbbbbbbbbbbbbbbbbbbbbbbbyyyyyyyyyyyyyyyyyyyyyyyyyyyyyyyyyyyyyyyyyyyyyyyyyyyyyyyyyyyMMMMMMMMMMMx
kbbbbbbbbbbbbbbbbbbbbbbbbbbbbbbbbbbbbbbbbbbbbbbbbbbbbbbbbbbbbbbbbbbbbyyyyyyyyyyyyyyyyyyyyyyyyyyyyyyyyyyyyyyyyyyyyyyyyyyyyyyyyyyMMMMMMMMMMMMx
kbbbbbbbbbbbbbbbbbbbbbbbbbbbbbbbbbbbbbbbbbbbbbbbbbbbbbbbbbbbbbbbbbbbbyyyyyyyyyyyyyyyyyyyyyyyyyyyyyyyyyyyyyyyyyyyyyyyyyyyyyyyyyMMMMMMMMMMMMMx
kbbbbbbbbbbbbbbbbbbbbbbbbbbbbbbbbbbbbbbbbbbbbbbbbbbbbbbbbbbbbbbbbbbbbyyyyyyyyyyyyyyyyyyyyyyyyyyyyyyyyyyyyyyyyyyyyyyyyyyyyyyyyyMMMMMMMMMMMMMx
kbbbbbbbbbbbbbbbbbbbbbbbbbbbbbbbbbbbbbbbbbbbbbbbbbbbbbbbbbbbbbbbbbbbbyyyyyyyyyyyyyyyyyyyyyyyyyyyyyyyyyyyyyyyyyyyyyyyyyyyyyyyyyMMMMMMMMMMMMMx
kbbbbbbbbbbbbbbbbbbbbbbbbbbbbbbbbbbbbbbbbbbbbbbbbbbbbbbbbbbbbbbbbbbbbyyyyyyyyyyyyyyyyyyyyyyyyyyyyyyyyyyyyyyyyyyyyyyyyyyyyyyyyyMMMMMMMMMMMMMx
kbbbbbbbbbbbbbbbbbbbbbbbbbbbbbbbbbbbbbbbbbbbbbbbbbbbbbbbbbbbbbbbbbbbbyyyyyyyyyyyyyyyyyyyyyyyyyyyyyyyyyyyyyyyyyyyyyyyyyyyyyyyyMMMMMMMMMMMMMMx
kbbbbbbbbbbbbbbbbbbbbbbbbbbbbbbbbbbbbbbbbbbbbbbbbbbbbbbbbbbbbbbbbbbbbyyyyyyyyyyyyyyyyyyyyyyyyyyyyyyyyyyyyyyyyyyyyyyyyyyyyyyyMMMMMMMMMMMMMMMx
kbbbbbbbbbbbbbbbbbbbbbbbbbbbbbbbbbbbbbbbbbbbbbbbbbbbbbbbbbbbbbbbbbbbbyyyyyyyyyyyyyyyyyyyyyyyyyyyyyyyyyyyyyyyyyyyyyyyyyyyyyyyMMMMMMMMMMMMMMMx
kbbbbbbbbbbbbbbbbbbbbbbbbbbbbbbbbbbbbbbbbbbbbbbbbbbbbbbbbbbbbbbbbbbbbyyyyyyyyyyyyyyyyyyyyyyyyyyyyyyyyyyyyyyyyyyyyyyyyyyyyyyyMMMMMMMMMMMMMMMx
kbbbbbbbbbbbbbbbbbbbbbbbbbbbbbbbbbbbbbbbbbbbbbbbbbbbbbbbbbbbbbbbbbbbbyyyyyyyyyyyyyyyyyyyyyyyyyyyyyyyyyyyyyyyyyyyyyyyyyyyyyyyMMMMMMMMMMMMMMMx
kbbbbbbbbbbbbbbbbbbbbbbbbbbbbbbbbbbbbbbbbbbbbbbbbbbbbbbbbbbbbbbbbbbbbyyyyyyyyyyyyyyyyyyyyyyyyyyyyyyyyyyyyyyyyyyyyyyyyyyyyyyyMMMMMMMMMMMMMMMx
kbbbbbbbbbbbbbbbbbbbbbbbbbbbbbbbbbbbbbbbbbbbbbbbbbbbbbbbbbbbbbbbbbbbbyyyyyyyyyyyyyyyyyyyyyyyyyyyyyyyyyyyyyyyyyyyyyyyyyyyyyyyMMMMMMMMMMMMMMMx
kbbbbbbbbbbbbbbbbbbbbbbbbbbbbbbbbbbbbbbbbbbbbbbbbbbbbbbbbbbbbbbbbbbbbyyyyyyyyyyyyyyyyyyyyyyyyyyyyyyyyyyyyyyyyyyyyyyyyyyyyyyyMMMMMMMMMMMMMMMx
kbbbbbbbbbbbbbbbbbbbbbbbbbbbbbbbbbbbbbbbbbbbbbbbbbbbbbbbbbbbbbbbbbbbbyyyyyyyyyyyyyyyyyyyyyyyyyyyyyyyyyyyyyyyyyyyyyyyyyyyyyyyMMMMMMMMMMMMMMMx
kbbbbbbbbbbbbbbbbbbbbbbbbbbbbbbbbbbbbbbbbbbbbbbbbbbbbbbbbbbbbbbbbbbbbyyyyyyyyyyyyyyyyyyyyyyyyyyyyyyyyyyyyyyyyyyyyyyyyyyyyyyyMMMMMMMMMMMMMMMx
kbbbbbbbbbbbbbbbbbbbbbbbbbbbbbbbbbbbbbbbbbbbbbbbbbbbbbbbbbbbbbbbbbbbbyyyyyyyyyyyyyyyyyyyyyyyyyyyyyyyyyyyyyyyyyyyyyyyyyyyyyyyMMMMMMMMMMMMMMMx
kbbbbbbbbbbbbbbbbbbbbbbbbbbbbbbbbbbbbbbbbbbbbbbbbbbbbbbbbbbbbbbbbbbbbyyyyyyyyyyyyyyyyyyyyyyyyyyyyyyyyyyyyyyyyyyyyyyyyyyyyyyyMMMMMMMMMMMMMMMx
kbbbbbbbbbbbbbbbbbbbbbbbbbbbbbbbbbbbbbbbbbbbbbbbbbbbbbbbbbbbbbbbbbbbbyyyyyyyyyyyyyyyyyyyyyyyyyyyyyyyyyyyyyyyyyyyyyyyyyyyyyyyMMMMMMMMMMMMMMMx
kbbbbbbbbbbbbbbbbbbbbbbbbbbbbbbbbbbbbbbbbbbbbbbbbbbbbbbbbbbbbbbbbbbbbyyyyyyyyyyyyyyyyyyyyyyyyyyyyyyyyyyyyyyyyyyyyyyyyyyyyyyyMMMMMMMMMMMMMMMx
kbbbbbbbbbbbbbbbbbbbbbbbbbbbbbbbbbbbbbbbbbbbbbbbbbbbbbbbbbbbbbbbbbbbbyyyyyyyyyyyyyyyyyyyyyyyyyyyyyyyyyyyyyyyyyyyyyyyyyyyyyyyMMMMMMMMMMMMMMMx
kbbbbbbbbbbbbbbbbbbbbbbbbbbbbbbbbbbbbbbbbbbbbbbbbbbbbbbbbbbbbbbbbbbbbyyyyyyyyyyyyyyyyyyyyyyyyyyyyyyyyyyyyyyyyyyyyyyyyyyyyyyyMMMMMMMMMMMMMMMx
kbbbbbbbbbbbbbbbbbbbbbbbbbbbbbbbbbbbbbbbbbbbbbbbbbbbbbbbbbbbbbbbbbbbbyyyyyyyyyyyyyyyyyyyyyyyyyyyyyyyyyyyyyyyyyyyyyyyyyyyyyyyMMMMMMMMMMMMMMMx
kbbbbbbbbbbbbbbbbbbbbbbbbbbbbbbbbbbbbbbbbbbbbbbbbbbbbbbbbbbbbbbbbbbbbyyyyyyyyyyyyyyyyyyyyyyyyyyyyyyyyyyyyyyyyyyyyyyyyyyyyyyyMMMMMMMMMMMMMMMx
kbbbbbbbbbbbbbbbbbbbbbbbbbbbbbbbbbbbbbbbbbbbbbbbbbbbbbbbbbbbbbbbbbbbbyyyyyyyyyyyyyyyyyyyyyyyyyyyyyyyyyyyyyyyyyyyyyyyyyyyyyyyMMMMMMMMMMMMMMMx
kbbbbbbbbbbbbbbbbbbbbbbbbbbbbbbbbbbbbbbbbbbbbbbbbbbbbbbbbbbbbbbbbbbbbyyyyyyyyyyyyyyyyyyyyyyyyyyyyyyyyyyyyyyyyyyyyyyyyyyyyyyyMMMMMMMMMMMMMMMx
kbbbbbbbbbbbbbbbbbbbbbbbbbbbbbbbbbbbbbbbbbbbbbbbbbbbbbbbbbbbbbbbbbbbbyyyyyyyyyyyyyyyyyyyyyyyyyyyyyyyyyyyyyyyyyyyyyyyyyyyyyyyMMMMMMMMMMMMMMMx
kbbbbbbbbbbbbbbbbbbbbbbbbbbbbbbbbbbbbbbbbbbbbbbbbbbbbbbbbbbbbbbbbbbbbyyyyyyyyyyyyyyyyyyyyyyyyyyyyyyyyyyyyyyyyyyyyyyyyyyyyyyyMMMMMMMMMMMMMMMx
kbbbbbbbbbbbbbbbbbbbbbbbbbbbbbbbbbbbbbbbbbbbbbbbbbbbbbbbbbbbbbbbbbbbbyyyyyyyyyyyyyyyyyyyyyyyyyyyyyyyyyyyyyyyyyyyyyyyyyyyyyyyMMMMMMMMMMMMMMMx
kbbbbbbbbbbbbbbbbbbbbbbbbbbbbbbbbbbbbbbbbbbbbbbbbbbbbbbbbbbbbbbbbbbbbyyyyyyyyyyyyyyyyyyyyyyyyyyyyyyyyyyyyyyyyyyyyyyyyyyyyyyyMMMMMMMMMMMMMMMx
kbbbbbbbbbbbbbbbbbbbbbbbbbbbbbbbbbbbbbbbbbbbbbbbbbbbbbbbbbbbbbbbbbbbbyyyyyyyyyyyyyyyyyyyyyyyyyyyyyyyyyyyyyyyyyyyyyyyyyyyyyyyMMMMMMMMMMMMMMMx
kbbbbbbbbbbbbbbbbbbbbbbbbbbbbbbbbbbbbbbbbbbbbbbbbbbbbbbbbbbbbbbbbbbbbyyyyyyyyyyyyyyyyyyyyyyyyyyyyyyyyyyyyyyyyyyyyyyyyyyyyyyyMMMMMMMMMMMMMMMx
kbbbbbbbbbbbbbbbbbbbbbbbbbbbbbbbbbbbbbbbbbbbbbbbbbbbbbbbbbbbbbbbbbbbbyyyyyyyyyyyyyyyyyyyyyyyyyyyyyyyyyyyyyyyyyyyyyyyyyyyyyyyMMMMMMMMMMMMMMMx
kbbbbbbbbbbbbbbbbbbbbbbbbbbbbbbbbbbbbbbbbbbbbbbbbbbbbbbbbbbbbbbbbbbbbyyyyyyyyyyyyyyyyyyyyyyyyyyyyyyyyyyyyyyyyyyyyyyyyyyyyyyyMMMMMMMMMMMMMMMx
kbbbbbbbbbbbbbbbbbbbbbbbbbbbbbbbbbbbbbbbbbbbbbbbbbbbbbbbbbbbbbbbbbbbbyyyyyyyyyyyyyyyyyyyyyyyyyyyyyyyyyyyyyyyyyyyyyyyyyyyyyyyMMMMMMMMMMMMMMMx
mggggggggggggggggggggggggggggggggggggggggggggggggggggggggggggggggggggfffffffffffffffffffffffffffffffffffffffffffffffffffffffoooooooooooooooC
mggggggggggggggggggggggggggggggggggggggggggggggggggggggggggggggggggggfffffffffffffffffffffffffffffffffffffffffffffffffffffffoooooooooooooooC
mggggggggggggggggggggggggggggggggggggggggggggggggggggggggggggggggggggfffffffffffffffffffffffffffffffffffffffffffffffffffffffoooooooooooooooC
mggggggggggggggggggggggggggggggggggggggggggggggggggggggggggggggggggggfffffffffffffffffffffffffffffffffffffffffffffffffffffffoooooooooooooooC
mggggggggggggggggggggggggggggggggggggggggggggggggggggggggggggggggggggfffffffffffffffffffffffffffffffffffffffffffffffffffffffoooooooooooooooC
mggggggggggggggggggggggggggggggggggggggggggggggggggggggggggggggggggggfffffffffffffffffffffffffffffffffffffffffffffffffffffffoooooooooooooooC
mggggggggggggggggggggggggggggggggggggggggggggggggggggggggggggggggggggfffffffffffffffffffffffffffffffffffffffffffffffffffffffoooooooooooooooC
mggggggggggggggggggggggggggggggggggggggggggggggggggggggggggggggggggggfffffffffffffffffffffffffffffffffffffffffffffffffffffffoooooooooooooooC
mggggggggggggggggggggggggggggggggggggggggggggggggggggggggggggggggggggffffffffffffffffffffffffffffffffffffffffffffffffffffffooooooooooooooooC
mggggggggggggggggggggggggggggggggggggggggggggggggggggggggggggggggggggffffffffffffffffffffffffffffffffffffffffffffffffffffffooooooooooooooooC
mggggggggggggggggggggggggggggggggggggggggggggggggggggggggggggggggggggffffffffffffffffffffffffffffffffffffffffffffffffffffffooooooooooooooooC
mggggggggggggggggggggggggggggggggggggggggggggggggggggggggggggggggggggffffffffffffffffffffffffffffffffffffffffffffffffffffffooooooooooooooooC
mggggggggggggggggggggggggggggggggggggggggggggggggggggggggggggggggggggffffffffffffffffffffffffffffffffffffffffffffffffffffffooooooooooooooooC
mggggggggggggggggggggggggggggggggggggggggggggggggggggggggggggggggggggffffffffffffffffffffffffffffffffffffffffffffffffffffffooooooooooooooooC
mggggggggggggggggggggggggggggggggggggggggggggggggggggggggggggggggggggffffffffffffffffffffffffffffffffffffffffffffffffffffffooooooooooooooooC
mggggggggggggggggggggggggggggggggggggggggggggggggggggggggggggggggggggfffffffffffffffffffffffffffffffffffffffffffffffffffffffoooooooooooooooC
mggggggggggggggggggggggggggggggggggggggggggggggggggggggggggggggggggggfffffffffffffffffffffffffffffffffffffffffffffffffffffffoooooooooooooooC
mggggggggggggggggggggggggggggggggggggggggggggggggggggggggggggggggggggfffffffffffffffffffffffffffffffffffffffffffffffffffffffoooooooooooooooC
mggggggggggggggggggggggggggggggggggggggggggggggggggggggggggggggggggggfffffffffffffffffffffffffffffffffffffffffffffffffffffffoooooooooooooooC
mggggggggggggggggggggggggggggggggggggggggggggggggggggggggggggggggggggfffffffffffffffffffffffffffffffffffffffffffffffffffffffoooooooooooooooC
tzzzzggggggggggggggggggggggggggggggggggggggggggggggggggggggggggggggggfffffffffffffffffffffffffffffffffffffffffffffffffffffffoooooooooooooooC
tzzzzzzzzggggggggggggggggggggggggggggggggggggggggggggggggggggggggggggfffffffffffffffffffffffffffffffffffffffffffffffffffffffoooooooooooooooC
tzzzzzzzzzzggggggggggggggggggggggggggggggggggggggggggggggggggggggggggfffffffffffffffffffffffffffffffffffffffffffffffffffffffoooooooooooooooC
tzzzzzzzzzzzzggggggggggggggggggggggggggggggggggggggggggggggggggggggggffffffffffffffffffffffffffffffffffffffffffffffffffffffooooooooooooooooC
tzzzzzzzzzzzzzzzgggggggggggggggggggggggggggggggggggggggggggggggggggggffffffffffffffffffffffffffffffffffffffffffffffffffffffooooooooooooooooC
tzzzzzzzzzzzzzzzzggggggggggggggggggggggggggggggggggggggggggggggggggggffffffffffffffffffffffffffffffffffffffffffffffffffffffooooooooooooooooC
tzzzzzzzzzzzzzzzzggggggggggggggggggggggggggggggggggggggggggggggggggggffffffffffffffffffffffffffffffffffffffffffffffffffffffooooooooooooooooC
tzzzzzzzzzzzzzzzzzgggggggggggggggggggggggggggggggggggggggggggggggggggffffffffffffffffffffffffffffffffffffffffffffffffffffffooooooooooooooooC
tzzzzzzzzzzzzzzzzzzggggggggggggggggggggggggggggggggggggggggggggggggggffffffffffffffffffffffffffffffffffffffffffffffffffffffooooooooooooooooC
tzzzzzzzzzzzzzzzzzzzgggggggggggggggggggggggggggggggggggggggggggggggggffffffffffffffffffffffffffffffffffffffffffffffffffffffooooooooooooooooC
tzzzzzzzzzzzzzzzzzzzzggggggggggggggggggggggggggggggggggggggggggggggggfffffffffffffffffffffffffffffffffffffffffffffffffffffoooooooooooooooooC
tzzzzzzzzzzzzzzzzzzzzzgggggggggggggggggggggggggggggggggggggggggggggggffffffffffffffffffffffffffffffffffffffffffffffffffffooooooooooooooooooC
tzzzzzzzzzzzzzzzzzzzzzzzgggggggggggggggggggggggggggggggggggggggggggggffffffffffffffffffffffffffffffffffffffffffffffffffffooooooooooooooooooC
tzzzzzzzzzzzzzzzzzzzzzzzzzgggggggggggggggggggggggggggggggggggggggggggfffffffffffffffffffffffffffffffffffffffffffffffffffoooooooooooooooooooC
tzzzzzzzzzzzzzzzzzzzzzzzzzzzgggggggggggggggggggggggggggggggggggggggggfffffffffffffffffffffffffffffffffffffffffffffffffffoooooooooooooooooooC
tTzzzzzzzzzzzzzzzzzzzzzzzzzzzzgggggggggggggggggggggggggggggggggggggggffffffffffffffffffffffffffffffffffffffffffffffffffooooooooooooooooooooC
tTzzzzzzzzzzzzzzzzzzzzzzzzzzzzzzzzgggggggggggggggggggggggggggggggggggffffffffffffffffffffffffffffffffffffffffffffffffffooooooooooooooooooooC
tTzzzzzzzzzzzzzzzzzzzzzzzzzzzzzzzzzzzggggggggggggggggggggggggggggggggfffffffffffffffffffffffffffffffffffffffffffffffffoooooooooooooooooooooC
tTzzzzzzzzzzzzzzzzzzzzzzzzzzzzzzzzzzzzzzzzgggggggggggggggggggggggggggffffffffffffffffffffffffffffffffffffffffffffffffooooooooooooooooooooooC
tTzzzzzzzzzzzzzzzzzzzzzzzzzzzzzzzzzzzzzzzzzzzzzzzzzzzzzggggggggggggggfffffffffffffffffffffffffffffffffffffffffffffffoooooooooooooooooooooooC
tTzzzzzzzzzzzzzzzzzzzzzzzzzzzzzzzzzzzzzzzzzzzzzzzzzzzzzzzzzzzzzzzzzzzjjjjjjjjjjjjjjjjjjjjjjjfjfjfjjjjjjjjjjjoooooooooooooooooooooooooooooooC
tTzzzzzzzzzzzzzzzzzzzzzzzzzzzzzzzzzzzzzzzzzzzzzzzzzzzzzzzzzzzzzzzzzzzjjjjjjjjjjjjjjjjjjjjjjjjjjjjjjjjjjjjjjjoooooooooooooooooooooooooooooooC
tTzzzzzzzzzzzzzzzzzzzzzzzzzzzzzzzzzzzzzzzzzzzzzzzzzzzzzzzzzzzzzzzzzzzjjjjjjjjjjjjjjjjjjjjjjjjjjjjjjjjjjjjjjooooooooooooooooooooooooooooooooC
tTzzzzzzzzzzzzzzzzzzzzzzzzzzzzzzzzzzzzzzzzzzzzzzzDDDDDDDDDDDDDDDDDDDDDDDDDDDDDDDDDDDDDDDDjjjjjjjjjjjjjjjjjjooooooooooooooooooooooooooooooooC
tTzzzzzzzzzzzzzzzzzzzzzzzzzzzzzzzzzzzzzzzzzzzzzzzDDDDDDDDDDDDDDDDDDDDDDDDDDDDDDDDDDDDDDDDjjjjjjjjjjjjjjjjjjooooooooooooooooooooooooooooooooC
tTzzzzzzzzzzzzzzzzzzzzzzzzzzzzzzzzzzzzzzzzzzzzzzzDDDDDDDDDDDDDDDDDDDDDDDDDDDDDDDDDDDDDDDDjjjjjjjjjjjjjjjjjoooooooooooooooooooooooooooooooooC
tTTzzzzzzzzzzzzzzzzzzzzzzzzzzzzzzzzzzzzzzzzzzzzzzDDDDDDDDDDDDDDDDDDDDDDDDDDDDDDDDDDDDDDDDjjjjjjjjjjjjjjjjjoooooooooooooooooooooooooooooooooC
tTTzzzzzzzzzzzzzzzzzzzzzzzzzzzzzzzzzzzzzzzzzzzzzzDDDDDDDDDDDDDDDDDDDDDDDDDDDDDDDDDDDDDDDDjjjjjjjjjjjjjjjjjoooooooooooooooooooooooooooooooooC
tTTzzzzzzzzzzzzzzzzzzzzzzzzzzzzzzzzzzzzzzzzzzzzzzDDDDDDDDDDDDDDDDDDDDDDDDDDDDDDDDDDDDDDDDjjjjjjjjjjjjjjjjooooooooooooooooooooooooooooooooooC
tTTzzzzzzzzzzzzzzzzzzzzzzzzzzzzzzzzzzzzzzzzzzzzzzDDDDDDDDDDDDDDDDDDDDDDDDDDDDDDDDDDDDDDDDjjjjjjjjjjjjjjjjooooooooooooooooooooooooooooooooooC
tTTTzzzzzzzzzzzzzzzzzzzzzzzzzzzzzzzzzzzzzzzzzzzzzDDDDDDDDDDDDDDDDDDDDDDDDDDDDDDDDDDDDDDDDjjjjjjjjjjjjjjjjooooooooooooooooooooooooooooooooooC
tTTTTTzzzzzzzzzzzzzzzzzzzzzzzzzzzzzzzzzzzzzzzzzzzDDDDDDDDDDDDDDDDDDDDDDDDDDDDDDDDDDDDDDDDjjjjjjjjjjjjjjjoooooooooooooooooooooooooooooooooooC
tTTTTTTTTzzzzzzzzzzzzzzzzzzzzzzzzzzzzzzzzzzzzzzzzDDDDDDDDDDDDDDDDrEDDDDGSDDDDDDDDDDDDDDDDjjjjjjjjjjjjjjjoooooooooooooooooooooooooooooooooooC
tTTTTTTTTTTTTTzzzzzzzzzzzzzzzzzzzzzzzzzzzzzzzzzzzDDDDDDDDDDDDDDDDUKDDDDUKDDDDDDDDDDDDDDDDjjjjjjjjjjjjjjjoooooooooooooooooooooooooooooooooooC
tTTTTTTTTTTTTTTTTTTTTTTTTTTzzzzzzzzzzzzzzzzzzzzzzDDDDDDDDDDDDDDDDUKDDDDUKDDDDDDDDDDDDDDDDjjjjjjjjjjjjjjooooooooooooooooooooooooooooooooooooC
tTTTTTTTTTTTTTTTTTTTTTTTTTTTTTzzzzzzzzzzzzzzzzzzzDDDDDDDDDDDDDDDDUKDDDDUKDDDDDDDDDDDDDDDDjjjjjjjjjjjjjjooooooooooooooooooooooooooooooooooooC
tTTTTTTTTTTTTTTTTTTTTTTTTTTTTTTTTzzzzzzzzzzzzzzzzDDDDDDDDDDDDDDDDDDDDDDDDDDDDDDDDDDDDDDDDjjjjjjjjjjjjjoooooooooooooooooooooooooooooooooooooC
tTTTTTTTTTTTTTTTTTTTTTTTTTTTTTTTTTzzzzzzzzzzzzzzzDDDDDDDDDDDDDDDDDDDDDDDDDDDDDDDDDDDDDDDDjjjjjjjjjjjjjoooooooooooooooooooooooooooooooooooooC
tTTTTTTTTTTTTTTTTTTTTTTTTTTTTTTTTTTTzzzzzzzzzzzzzDDDDDDDDDDDDDDDDDDDDDDDDDDDDDDDDDDDDDDDDjjjjjjjjjjjjooooooooooooooooooooooooooooooooooooooC
tTTTTTTTTTTTTTTTTTTTTTTTTTTTTTTTTTTTTTzzzzzzzzzzzDDDDDDDDDDDDDDDDDDDDDDDDDDDDDDDDDDDDDDDDjjjjjjjjjjjoooooooooooooooooooooooooooooooooooooooC
tTTTTTTTTTTTTTTTTTTTTTTTTTTTTTTTTTTTTTTTzzzzzzzzzDDDDDDDDDDDDDDDDDDDDDDDDDDDDDDDDDDDDDDDDjjjjjjjjjjooooooooooooooooooooooooooooooooooooooooC
tTTTTTTTTTTTTTTTTTTTTTTTTTTTTTTTTTTTTTTTTTTzzzzzzDDDDDDDDDDDDDDDDDDDDDDDDDDDDDDDDDDDDDDDDjjjjjjjjjoooooooooooooooooooooooooooooooooooooooooC
tTTTTTTTTTTTTTTTTTTTTTTTTTTTTTTTTTTTTTTTTTTzzzzzzDDDDDDDDDDDDDDDDDDDDDDDDDDDDDDDDDDDDDDDDjjjjjjjjooooooooooooooooooooooooooooooooooooooooooC
tTTTTTTTTTTTTTTTTTTTTTTTTTTTTTTTTTTTTTTTTTTTzzzzzDDDDDDDDDDDDDDDDDDDDDDDDDDDDDDDDDDDDDDDDjjjjjjjoooooooooooooooooooooooooooooooooooooooooooC
tTTTTTTTTTTTTTTTTTTTTTTTTTTTTTTTTTTTTTTTTTTTzzzzzDDDDDDDDDDDDDDDDDDDDDDDDDDDDDDDDDDDDDDDDjjjjjjooooooooooooooooooooooooooooooooooooooooooooC
tTTTTTTTTTTTTTTTTTTTTTTTTTTTTTTTTTTTTTTTTTTTTzzzzzzzzzzzzzzzzzzzzzzzzjjjjjjjjjjjjjjjjjjjjjjjjjoooooooooooooooooooooooooooooooooooooooooooooC
tTTTTTTTTTTTTTTTTTTTTTTTTTTTTTTTTTTTTTTTTTTTTTzzzzzzzzzzzzzzzzzzzzzzzjjjjjjjjjjjjjjjjjjjjjjjoooooooooooooooooooooooooooooooooooooooooooooooC
tTTTTTTTTTTTTTTTTTTTTTTTTTTTTTTTTTTTTTTTTTTTTTTTTTTTTTTTTTTTTTTTTTTTTooooooooooooooooooooooooooooooooooooooooooooooooooooooooooooooooooooooC
wttttttttttttttttttttttttttttttttttttttttttttttttttttttttttttttttttttCCCCCCCCCCCCCCCCCCCCCCCCCCCCCCCCCCCCCCCCCCCCCCCCCCCCCCCCCCCCCCCCCCCCCCC
"}
