"a" = (/turf/simulated/floor/outdoors/grass/athena,/area/odysseybase/level1/nw)
"b" = (/turf/unsimulated/wall/planetary/athena,/area/odysseybase/level1/nw)
"g" = (/turf/unsimulated/wall/planetary/athena,/area/odysseybase/level1/se)
"h" = (/turf/simulated/mineral/athena,/area/odysseybase/level1/sw)
"i" = (/turf/unsimulated/wall/planetary/normal/athena,/area/odysseybase/beach/water)
"j" = (/turf/simulated/mineral/athena,/area/odysseybase/level1/nw)
"k" = (/turf/simulated/open/athena,/area/odysseybase/level1/sw)
"l" = (/turf/simulated/floor/water/beach/athena{dir = 10},/area/odysseybase/beach)
"n" = (/turf/simulated/floor/water/athena,/area/odysseybase/beach/coast)
"o" = (/turf/simulated/floor/beach/sand/desert/outdoors/athena,/area/odysseybase/beach)
"q" = (/turf/simulated/floor/beach/sand/outdoors/athena,/area/odysseybase/beach)
"s" = (/turf/simulated/floor/water/beach/corner/athena{dir = 1},/area/odysseybase/beach)
"v" = (/turf/simulated/floor/outdoors/grass/athena,/area/odysseybase/level1/ne)
"z" = (/obj/effect/landmark{name = "Observer-Start"},/turf/simulated/floor/outdoors/grass/athena,/area/odysseybase/level1/ne)
"A" = (/turf/simulated/floor/water/beach/athena{dir = 8},/area/odysseybase/beach)
"B" = (/turf/simulated/floor/outdoors/grass/athena,/area/odysseybase/level1/sw)
"C" = (/turf/unsimulated/wall/planetary/normal/athena,/area/odysseybase/level1/ne)
"E" = (/turf/unsimulated/wall/planetary/athena,/area/odysseybase/level1/sw)
"H" = (/turf/simulated/floor/outdoors/grass/athena,/area/odysseybase/level1/se)
"I" = (/turf/simulated/floor/water/beach/athena,/area/odysseybase/beach)
"P" = (/turf/simulated/floor/water/deep/athena,/area/odysseybase/beach/water)
"R" = (/turf/simulated/mineral/athena,/area/odysseybase/level1/ne)
"U" = (/turf/simulated/mineral/athena,/area/odysseybase/level1/se)
"V" = (/turf/simulated/floor/water/athena,/area/odysseybase/beach/water)
"W" = (/turf/unsimulated/wall/planetary/normal/athena,/area/odysseybase/level1/nw)
"X" = (/turf/unsimulated/wall/planetary/athena,/area/odysseybase/level1/ne)
"Z" = (/turf/simulated/open/athena,/area/odysseybase/level1/se)

(1,1,1) = {"
bbbbbbbbbbbbbbbbbbbbbbbbbbbbbbbbbbWWWWWWWWWWWWWWWWWWWWWWWWWWWWWWWWCCCCCCCCCCCCCCCCCCCCCCCCCCCCCCCCCCCCCCCCCCCCCCCXXXXXXXXXXXXXXXXXXXXXXXXXXX
bjjjjjjjjjjjjjjjjjjjjjjjjjjjjjjjjjooqqqqqqqqqqqqqqqqqqaaaaaaaaaaaavvvvvvvvvvvvvvvvvvvvvvvvvvvvvvvvvvvvvvvvvvvvvvvRRRRRRRRRRRRRRRRRRRRRRRRRRX
bjjjjjjjjjjjjjjjjjjjjjjjjjjjjjjjooooqqqqqqqqqqqqqqqqaaaaaaaaaaaaaavvvvvvvvvvvvvvvvvvvvvvvvvvvvvvvvvvvvvvvvvvvvvvvRRRRRRRRRRRRRRRRRRRRRRRRRRX
bjjjjjjjjjjjjjjjjjjjjjjjjjjjjjoooooqqqqqqqqqqqqqqqaaaaaaaaaaaaaaaavvvvvvvvvvvvvvvvvvvvvvvvvvvvvvvvvvvvvvvvvvvvvvvvRRRRRRRRRRRRRRRRRRRRRRRRRX
bjjjjjjjjjjjjjjjjjjjjjjjjjjjoooooooqqqqqqqqqqqqqaaaaaaaaaaaaaaaaaavvvvvvvvvvvvvvvvvvvvvvvvvvvvvvvvvvvvvvvvvvvvvvvvvRRRRRRRRRRRRRRRRRRRRRRRRX
bjjjjjjjjjjjjjjjjjjjjjjjjjjooooooooqqqqqqqqqqqqaaaaaaaaaaaaaaaaaaavvvvvvvvvvvvvvvvvvvvvvvvvvvvvvvvvvvvvvvvvvvvvvvvvRRRRRRRRRRRRRRRRRRRRRRRRX
bjjjjjjjjjjjjjjjjjjjjjjjjoooooooooqqqqqqqqqqqaaaaaaaaaaaaaaaaaaaaavvvvvvvvvvvvvvvvvvvvvvvvvvvvvvvvvvvvvvvvvvvvvvvvvvRRRRRRRRRRRRRRRRRRRRRRRX
bjjjjjjjjjjjjjjjjjjjjjjjooooooooooqqqqqqqqqqaaaaaaaaaaaaaaaaaaaaaavvvvvvvvvvvvvvvvvvvvvvvvvvvvvvvvvvvvvvvvvvvvvvvvvvvRRRRRRRRRRRRRRRRRRRRRRX
bjjjjjjjjjjjjjjjjjjjjjjIsooooooooqqqqqqqqqqaaaaaaaaaaaaaaaaaaaaaaavvvvvvvvvvvvvvvvvvvvvvvvvvvvvvvvvvvvvvvvvvvvvvvvvvvRRRRRRRRRRRRRRRRRRRRRRX
bjjjjjjjjjjjjjjjjjjjjVVnlsoooooqqqqqqqqqqqaaaaaaaaaaaaaaaaaaaaaaaavvvvvvvvvvvvvvvvvvvvvvvvvvvvvvvvvvvvvvvvvvvvvvvvvvvRRRRRRRRRRRRRRRRRRRRRRX
bjjjjjjjjjjjjjjjjPPVVVVnnAoooooqqqqqqqqqqqaaaaaaaaaaaaaaaaaaaaaaaavvvvvvvvvvvvvvvvvvvvvvvvvvvvvvvvvvvvvvvvvvvvvvvvvvvvRRRRRRRRRRRRRRRRRRRRRX
bjjjjjjjjjjjPPPPPPPVVVVVnAooooooqqqqqqqqqaaaaaaaaaaaaaaaaaaaaaaaaavvvvvvvvvvvvvvvvvvvvvvvvvvvvvvvvvvvvvvvvvvvvvvvvvvvvRRRRRRRRRRRRRRRRRRRRRX
bjjjjPPPPPPPPPPPPPPVVVVVnAooooooqqqqqqqqqaaaaaaaaaaaaaaaaaaaaaaaaavvvvvvvvvvvvvvvvvvvvvvvvvvvvvvvvvvvvvvvvvvvvvvvvvvvvvRRRRRRRRRRRRRRRRRRRRX
bjjPPPPPPPPPPPPPPPPPVVVVnAooooooqqqqqqqqqaaaaaaaaaaaaaaaaaaaaaaaaavvvvvvvvvvvvvvvvvvvvvvvvvvvvvvvvvvvvvvvvvvvvvvvvvvvvvRRRRRRRRRRRRRRRRRRRRX
bjPPPPPPPPPPPPPPPPPPVVVVnAoooooqqqqqqqqqqaaaaaaaaaaaaaaaaaaaaaaaaavvvvvvvvvvvvvvvvvvvvvvvvvvvvvvvvvvvvvvvvvvvvvvvvvvvvvvRRRRRRRRRRRRRRRRRRRX
iPPPPPPPPPPPPPPPPPPPPVVVnAoooooqqqqqqqqqqaaaaaaaaaaaaaaaaaaaaaaaaavvvvvvvvvvvvvvvvvvvvvvvvvvvvvvvvvvvvvvvvvvvvvvvvvvvvvvRRRRRRRRRRRRRRRRRRRX
iPPPPPPPPPPPPPPPPPPPPVVVnAoooooqqqqqqqqqqaaaaaaaaaaaaaaaaaaaaaaaaavvvvvvvvvvvvvvvvvvvvvvvvvvvvvvvvvvvvvvvvvvvvvvvvvvvvvvRRRRRRRRRRRRRRRRRRRX
iPPPPPPPPPPPPPPPPPPPPVVVnAooooooqqqqqqqqqaaaaaaaaaaaaaaaaaaaaaaaaavvvvvvvvvvvvvvvvvvvvvvvvvvvvvvvvvvvvvvvvvvvvvvvvvvvvvvvRRRRRRRRRRRRRRRRRRX
iPPPPPPPPPPPPPPPPPPPPPVVnAooooooqqqqqqqqqaaaaaaaaaaaaaaaaaaaaaaaaavvvvvvvvvvvvvvvvvvvvvvvvvvvvvvvvvvvvvvvvvvvvvvvvvvvvvvvRRRRRRRRRRRRRRRRRRX
iPPPPPPPPPPPPPPPPPPPPPVVnAooooooqqqqqqqqqaaaaaaaaaaaaaaaaaaaaaaaaavvvvvvvvvvvvvvvvvvvvvvvvvvvvvvvvvvvvvvvvvvvvvvvvvvvvvvvRRRRRRRRRRRRRRRRRRX
iPPPPPPPPPPPPPPPPPPPPPVVnAooooooqqqqqqqqqaaaaaaaaaaaaaaaaaaaaaaaaavvvvvvvvvvvvvvvvvvvvvvvvvvvvvvvvvvvvvvvvvvvvvvvvvvvvvvvRRRRRRRRRRRRRRRRRRX
iPPPPPPPPPPPPPPPPPPPPPPVnAoooooqqqqqqqqqqaaaaaaaaaaaaaaaaaaaaaaaaavvvvvvvvvvvvvvvvvvvvvvvvvvvvvvvvvvvvvvvvvvvvvvvvvvvvvvvvRRRRRRRRRRRRRRRRRX
iPPPPPPPPPPPPPPPPPPPPPPVnAooooooqqqqqqqqqaaaaaaaaaaaaaaaaaaaaaaaaavvvvvvvvvvvvvvvvvvvvvvvvvvvvvvvvvvvvvvvvvvvvvvvvvvvvvvvvRRRRRRRRRRRRRRRRRX
iPPPPPPPPPPPPPPPPPPPPPPVnAooooooqqqqqqqqqaaaaaaaaaaaaaaaaaaaaaaaaavvvvvvvvvvvvvvvvvvvvvvvvvvvvvvvvvvvvvvvvvvvvvvvvvvvvvvvvRRRRRRRRRRRRRRRRRX
iPPPPPPPPPPPPPPPPPPPPPPVnAooooooqqqqqqqqqaaaaaaaaaaaaaaaaaaaaaaaaavvvvvvvvvvvvvvvvvvvvvvvvvvvvvvvvvvvvvvvvvvvvvvvvvvvvvvvvRRRRRRRRRRRRRRRRRX
iPPPPPPPPPPPPPPPPPPPPPPVnAooooooqqqqqqqqqaaaaaaaaaaaaaaaaaaaaaaaaavvvvvvvvvvvvvvvvvvvvvvvvvvvvvvvvvvvvvvvvvvvvvvvvvvvvvvvvvRRRRRRRRRRRRRRRRX
iPPPPPPPPPPPPPPPPPPPPPPVnAoooooqqqqqqqqqqaaaaaaaaaaaaaaaaaaaaaaaaavvvvvvvvvvvvvvvvvvvvvvvvvvvvvvvvvvvvvvvvvvvvvvvvvvvvvvvvvRRRRRRRRRRRRRRRRX
iPPPPPPPPPPPPPPPPPPPPPVVnAoooooqqqqqqqqqqaaaaaaaaaaaaaaaaaaaaaaaaavvvvvvvvvvvvvvvvvvvvvvvvvvvvvvvvvvvvvvvvvvvvvvvvvvvvvvvvvRRRRRRRRRRRRRRRRX
iPPPPPPPPPPPPPPPPPPPPPVVnAoooooqqqqqqqqqqaaaaaaaaaaaaaaaaaaaaaaaaavvvvvvvvvvvvvvvvvvvvvvvvvvvvvvvvvvvvvvvvvvvvvvvvvvvvvvvvvRRRRRRRRRRRRRRRRX
iPPPPPPPPPPPPPPPPPPPPVVVnAoooooqqqqqqqqqqaaaaaaaaaaaaaaaaaaaaaaaaavvvvvvvvvvvvvvvvvvvvvvvvvvvvvvvvvvvvvvvvvvvvvvvvvvvvvvvvvRRRRRRRRRRRRRRRRX
iPPPPPPPPPPPPPPPPPPPPVVVnAooooooqqqqqqqqqaaaaaaaaaaaaaaaaaaaaaaaaavvvvvvvvvvvvvvvvvvvvvvvvvvvvvvvvvvvvvvvvvvvvvvvvvvvvvvvvvRRRRRRRRRRRRRRRRX
iPPPPPPPPPPPPPPPPPPPVVVVnAoooooooqqqqqqqqaaaaaaaaaaaaaaaaaaaaaaaaavvvvvvvvvvvvvvvvvvvvvvvvvvvvvvvvvvvvvvvvvvvvvvvvvvvvvvvvvRRRRRRRRRRRRRRRRX
iPPPPPPPPPPPPPPPPPPVVVVVnAoooooooqqqqqqqqaaaaaaaaaaaaaaaaaaaaaaaaavvvvvvvvvvvvvvvvvvvvvvvvvvvvvvvvvvvvvvvvvvvvvvvvvvvvvvvvvRRRRRRRRRRRRRRRRX
iPPPPPPPPPPPPPPPPPPVVVVVnAoooooooqqqqqqqqaaaaaaaaaaaaaaaaaaaaaaaaavvvvvvvvvvvvvvvvvvvvvvvvvvvvvvvvvvvvvvvvvvvvvvvvvvvvvvvvvvRRRRRRRRRRRRRRRX
iPPPPPPPPPPPPPPPPPVVPVVVnAoooooooqqqqqqqqaaaaaaaaaaaaaaaaaaaaaaaaavvvvvvvvvvvvvvvvvvvvvvvvvvvvvvvvvvvvvvvvvvvvvvvvvvvvvvvvvvRRRRRRRRRRRRRRRX
iPPPPPPPPPPPPPPPPPVPPVVVnAoooooooqqqqqqqqaaaaaaaaaaaaaaaaaaaaaaaaavvvvvvvvvvvvvvvvvvvvvvvvvvvvvvvvvvvvvvvvvvvvvvvvvvvvvvvvvvRRRRRRRRRRRRRRRX
iPPPPPPPPPPPPPPPPVVPPVVVnAooooooqqqqqqqqqaaaaaaaaaaaaaaaaaaaaaaaaavvvvvvvvvvvvvvvvvvvvvvvvvvvvvvvvvvvvvvvvvvvvvvvvvvvvvvvvvvRRRRRRRRRRRRRRRX
iPPPPPPPPPPPVPPPPVPPVVVVnAooooooqqqqqqqqqaaaaaaaaaaaaaaaaaaaaaaaaavvvvvvvvvvvvvvvvvvvvvvvvvvvvvvvvvvvvvvvvvvvvvvvvvvvvvvvvvvRRRRRRRRRRRRRRRX
iPPPPPPPPPPVVPPPVVVVVVVVnAoooooqqqqqqqqqqaaaaaaaaaaaaaaaaaaaaaaaaavvvvvvvvvvvvvvvvvvvvvvvvvvvvvvvvvvvvvvvvvvvvvvvvvvvvvvvvvvRRRRRRRRRRRRRRRX
iPPPPPPPPPPVPPPPVPPPPVVVnAoooooqqqqqqqqqqaaaaaaaaaaaaaaaaaaaaaaaaavvvvvvvvvvvvvvvvvvvvvvvvvvvvvvvvvvvvvvvvvvvvvvvvvvvvvvvvvvRRRRRRRRRRRRRRRX
iPPPPPPPPPPVPPPVVPPPVVVVnAoooooqqqqqqqqqqaaaaaaaaaaaaaaaaaaaaaaaaavvvvvvvvvvvvvvvvvvvvvvvvvvvvvvvvvvvvvvvvvvvvvvvvvvvvvvvvvvRRRRRRRRRRRRRRRX
iPPPPPPPPPPVPPPVPPPVVVVVnAoooooqqqqqqqqqqaaaaaaaaaaaaaaaaaaaaaaaaavvvvvvvvvvvvvvvvvvvvvvvvvvvvvvvvvvvvvvvvvvvvvvvvvvvvvvvvvvRRRRRRRRRRRRRRRX
iPPPPPPPPPPVPPPVPPPVPVVVnAoooooqqqqqqqqqqaaaaaaaaaaaaaaaaaaaaaaaaavvvvvvvvvvvvvvvvvvvvvvvvvvvvvvvvvvvvvvvvvvvvvvvvvvvvvvvvvvRRRRRRRRRRRRRRRX
iPPPPPPPPPPVPVVVPPVVPVVVnAoooooqqqqqqqqqqaaaaaaaaaaaaaaaaaaaaaaaaavvvvvvvvvvvvvvvvvvvvvvvvvvvvvvvvvvvvvvvvvvvvvvvvvvvvvvvvvvRRRRRRRRRRRRRRRX
iPPPPPPPPPPVPVVPPPVPPVVVnAoooooqqqqqqqqqqaaaaaaaaaaaaaaaaaaaaaaaaazvvvvvvvvvvvvvvvvvvvvvvvvvvvvvvvvvvvvvvvvvvvvvvvvvvvvvvvvvRRRRRRRRRRRRRRRX
iPPPPPPPPPPVPVVPPPPPPVVVnAoooooqqqqqqqqqqaaaaaaaaaaaaaaaaaaaaaaaaavvvvvvvvvvvvvvvvvvvvvvvvvvvvvvvvvvvvvvvvvvvvvvvvvvvvvvvvvvRRRRRRRRRRRRRRRX
iPPPPPPPPPPVPVVPPPPPPPVVnAoooooqqqqqqqqqaaaaaaaaaaaaaaaaaaaaaaaaaavvvvvvvvvvvvvvvvvvvvvvvvvvvvvvvvvvvvvvvvvvvvvvvvvvvvvvvvvvRRRRRRRRRRRRRRRX
iPPPPPPPPPPVVVVPPPPPPPVVnAoooooqqqqqqqqqaaaaaaaaaaaaaaaaaaaaaaaaaavvvvvvvvvvvvvvvvvvvvvvvvvvvvvvvvvvvvvvvvvvvvvvvvvvvvvvvvvvRRRRRRRRRRRRRRRX
iPPPPPPPPPPPVVPPVVPPPPPVnAooooqqqqqqqqqaaaaaaaaaaaaaaaaaaaaaaaaaaavvvvvvvvvvvvvvvvvvvvvvvvvvvvvvvvvvvvvvvvvvvvvvvvvvvvvvvvvvRRRRRRRRRRRRRRRX
iPPPPPPPPPPPVVPPPVPPPPPVnAooooqqqqqqqqqaaaaaaaaaaaaaaaaaaaaaaaaaaavvvvvvvvvvvvvvvvvvvvvvvvvvvvvvvvvvvvvvvvvvvvvvvvvvvvvvvvvvRRRRRRRRRRRRRRRX
iPPPPPPPPPPPVVPPPVVPPPPVnAoooqqqqqqqqqqaaaaaaaaaaaaaaaaaaaaaaaaaaavvvvvvvvvvvvvvvvvvvvvvvvvvvvvvvvvvvvvvvvvvvvvvvvvvvvvvvvvvRRRRRRRRRRRRRRRX
iPPPPPPPPPPPVVPVPPVVPPPVnAoooqqqqqqqqqqaaaaaaaaaaaaaaaaaaaaaaaaaaavvvvvvvvvvvvvvvvvvvvvvvvvvvvvvvvvvvvvvvvvvvvvvvvvvvvvvvvvvRRRRRRRRRRRRRRRX
iPPPPPPPPPPPPVVVPPPVVPPVnAooqqqqqqqqqqqaaaaaaaaaaaaaaaaaaaaaaaaaaavvvvvvvvvvvvvvvvvvvvvvvvvvvvvvvvvvvvvvvvvvvvvvvvvvvvvvvvvvRRRRRRRRRRRRRRRX
iPPPPPPPPPPPPVVPPPPPVVVVnAooqqqqqqqqqqqaaaaaaaaaaaaaaaaaaaaaaaaaaavvvvvvvvvvvvvvvvvvvvvvvvvvvvvvvvvvvvvvvvvvvvvvvvvvvvvvvvvvRRRRRRRRRRRRRRRX
iPPPPPPPPPPPPVVPPVPPPVVVnAooqqqqqqqqqqqaaaaaaaaaaaaaaaaaaaaaaaaaaavvvvvvvvvvvvvvvvvvvvvvvvvvvvvvvvvvvvvvvvvvvvvvvvvvvvvvvvvvRRRRRRRRRRRRRRRX
iPPPPPPPPPPPPVVPPVVPPVVVnAooqqqqqqqqqqqBBBBBBBBBBBBBBBBBBBBBBBBBBBHHHHHHHHHHHHHHHHHHHHHHHHHHHHHHHHHHHHHHHHHHHHHHHHHHHHHHHHHHUUUUUUUUUUUUUUUg
iPPPPPPPPPPPPVVVPVVPPVVVnAooqqqqqqqqqqqBBBBBBBBBBBBBBBBBBBBBBBBBBBHHHHHHHHHHHHHHHHHHHHHHHHHHHHHHHHHHHHHHHHHHHHHHHHHHHHHHHHHHUUUUUUUUUUUUUUUg
iPPPPPPPPPPPPVPVVVVPPVVVnAooqqqqqqqqqqqBBBBBBBBBBBBBBBBBBBBBBBBBBBHHHHHHHHHHHHHHHHHHHHHHHHHHHHHHHHHHHHHHHHHHHHHHHHHHHHHHHHHHUUUUUUUUUUUUUUUg
iPPPPPPPPPPPPVPPVVVPPVVVnAoooqqqqqqqqqqBBBBBBBBBBBBBBBBBBBBBBBBBBBHHHHHHHHHHHHHHHHHHHHHHHHHHHHHHHHHHHHHHHHHHHHHHHHHHHHHHHHHHUUUUUUUUUUUUUUUg
iPPPPPPPPPPPPVVPPVVVPVVVnAoooqqqqqqqqqqBBBBBBBBBBBBBBBBBBBBBBBBBBBHHHHHHHHHHHHHHHHHHHHHHHHHHHHHHHHHHHHHHHHHHHHHHHHHHHHHHHHHHUUUUUUUUUUUUUUUg
iPPPPPPPPPPPPPVPPPVVVVVVnAoooqqqqqqqqqqBBBBBBBBBBBBBBBBBBBBBBBBBBBHHHHHHHHHHHHHHHHHHHHHHHHHHHHHHHHHHHHHHHHHHHHHHHHHHHHHHHHHHUUUUUUUUUUUUUUUg
iPPPPPPPPPPPPPPVPPPPVVVVnAooooqqqqqqqqqqBBBBBBBBBBBBBBBBBBBBBBBBBBHHHHHHHHHHHHHHHHHHHHHHHHHHHHHHHHHHHHHHHHHHHHHHHHHHHHHHHHHHUUUUUUUUUUUUUUUg
iPPPPPPPPPPPPPPPVVPPPPVVnAoooooqqqqqqqqqBBBBBBBBBBBBBBBBBBBBBBBBBBHHHHHHHHHHHHHHHHHHHHHHHHHHHHHHHHHHHHHHHHHHHHHHHHHHHHHHHHHHUUUUUUUUUUUUUUUg
iPPPPPPPPPPPPPPPPVVPPPVVnAoooooqqqqqqqqqqBBBBBBBBBBBBBBBBBBBBBBBBBHHHHHHHHHHHHHHHHHHHHHHHHHHHHHHHHHHHHHHHHHHHHHHHHHHHHHHHHHHUUUUUUUUUUUUUUUg
iPPPPPPPPPPPPPPPPPVVPPPVnAoooooqqqqqqqqqqBBBBBBBBBBBBBBBBBBBBBBBBBHHHHHHHHHHHHHHHHHHHHHHHHHHHHHHHHHHHHHHHHHHHHHHHHHHHHHHHHHHUUUUUUUUUUUUUUUg
iPPPPPPPPPPPPPPPPPPPPPPVnAooooooqqqqqqqqqBBBBBBBBBBBBBBBBBBBBBBBBBHHHHHHHHHHHHHHHHHHHHHHHHHHHHHHHHHHHHHHHHHHHHHHHHHHHHHHHHHHUUUUUUUUUUUUUUUg
iPPPPPPPPPPPPPPPPPPPPPPVnAooooooqqqqqqqqqBBBBBBBBBBBBBBBBBBBBBBBBBHHHHHHHHHHHHHHHHHHHHHHHHHHHHHHHHHHHHHHHHHHHHHHHHHHHHHHHHHHUUUUUUUUUUUUUUUg
iPPPPPPPPPPPPPPPPPPPPPVVnAooooooqqqqqqqqqBBBBBBBBBBBBBBBBBBBBBBBBBHHHHHHHHHHHHHHHHHHHHHHHHHHHHHHHHHHHHHHHHHHHHHHHHHHHHHHHHHHUUUUUUUUUUUUUUUg
iPPPPPPPPPPPPPPVVVVVVVVVnAooooooqqqqqqqqqBBBBBBBBBBBBBBBBBBBBBBBBBHHHHHHHHHHHHHHHHHHHHHHHHHHHHHHHHHHHHHHHHHHHHHHHHHHHHHHHHHHUUUUUUUUUUUUUUUg
iPPPPPPPPPPPPPVVVVVVVVVVnAooooooqqqqqqqqqBBBBBBBBBBBBBBBBBBBBBBBBBHHHHHHHHHHHHHHHHHHHHHHHHHHHHHHHHHHHHHHHHHHHHHHHHHHHHHHHHHHUUUUUUUUUUUUUUUg
iPPPPPPPPPPPPPVVVVVVVPVVnAoooooqqqqqqqqqqBBBBBBBBBBBBBBBBBBBBBBBBBHHHHHHHHHHHHHHHHHHHHHHHHHHHHHHHHHHHHHHHHHHHHHHHHHHHHHHHHHHUUUUUUUUUUUUUUUg
iPPPPPPPPPPPVVVVVVPPPPPPnAoooooqqqqqqqqqqBBBBBBBBBBBBBBBBBBBBBBBBBHHHHHHHHHHHHHHHHHHHHHHHHHHHHHHHHHHHHHHHHHHHHHHHHHHHHHHHHHHUUUUUUUUUUUUUUUg
iPPPPPPPPPVVVVVPPPPPPPPPnAoooooqqqqqqqqqqBBBBBBBBBBBBBBBBBBBBBBBBBHHHHHHHHHHHHHHHHHHHHHHHHHHHHHHHHHHHHHHHHHHHHHHHHHHHHHHHHHHUUUUUUUUUUUUUUUg
iPPPPPPPVVVVPPPPPPPPPPPPnAoooooqqqqqqqqqqBBBBBBBBBBBBBBBBBBBBBBBBBHHHHHHHHHHHHHHHHHHHHHHHHHHHHHHHHHHHHHHHHHHHHHHHHHHHHHHHHHHUUUUUUUUUUUUUUUg
iPPPPPPPPPPPPPPPPPPPPPPPnAoooooqqqqqqqqqqBBBBBBBBBBBBBBBBBBBBBBBBBHHHHHHHHHHHHHHHHHHHHHHHHHHHHHHHHHHHHHHHHHHHHHHHHHHHHHHHHHHUUUUUUUUUUUUUUUg
iPPPPPPPPPPPPPPPPPPPPPPPnAoooooqqqqqqqqqqBBBBBBBBBBBBBBBBBBBBBBBBBHHHHHHHHHHHHHHHHHHHHHHHHHHHHHHHHHHHHHHHHHHHHHHHHHHHHHHHHHHUUUUUUUUUUUUUUUg
iPPPPPPPPPPPPPPPPPPPPPPPnAoooooqqqqqqqqqqBBBBBBBBBBBBBBBBBBBBBBBBBHHHHHHHHHHHHHHHHHHHHHHHHHHHHHHHHHHHHHHHHHHHHHHHHHHHHHHHHHHUUUUUUUUUUUUUUUg
iPPPPPPPPPPPPPPPPPPPPPPVnAoooooqqqqqqqqqqBBBBBBBBBBBBBBBBBBBBBBBBBHHHHHHHHHHHHHHHHHHHHHHHHHHHHHHHHHHHHHHHHHHHHHHHHHHHHHHHHHHUUUUUUUUUUUUUUUg
iPPPPPPPPPPPPPPPPPPPPPPVnAoooooqqqqqqqqqqBBBBBBBBBBBBBBBBBBBBBBBBBHHHHHHHHHHHHHHHHHHHHHHHHHHHHHHHHHHHHHHHHHHHHHHHHHHHHHHHHHHUUUUUUUUUUUUUUUg
iPPPPPPPPPPPPPPPPPPPPPVVnAooooooqqqqqqqqqBBBBBBBBBBBBBBBBBBBBBBBBBHHHHHHHHHHHHHHHHHHHHHHHHHHHHHHHHHHHHHHHHHHHHHHHHHHHHHHHHHUUUUUUUUUUUUUUUUg
iPPPPPPPPPPPPPPPPPPVVVVVnAooooooqqqqqqqqqBBBBBBBBBBBBBBBBBBBBBBBBBHHHHHHHHHHHHHHHHHHHHHHHHHHHHHHHHHHHHHHHHHHHHHHHHHHHHHHHHHUUUUUUUUUUUUUUUUg
iPPPPPPPPPPPPPPPPPVVVVVVnAooooooqqqqqqqqqBBBBBBBBBBBBBBBBBBBBBBBBBHHHHHHHHHHHHHHHHHHHHHHHHHHHHHHHHHHHHHHHHHHHHHHHHHHHHHHHHHUUUUUUUUUUUUUUUUg
iPPPPPPPPPPPPPPPPVVVVVVVnAooooooqqqqqqqqqBBBBBBBBBBBBBBBBBBBBBBBBBHHHHHHHHHHHHHHHHHHHHHHHHHHHHHHHHHHHHHHHHHHHHHHHHHHHHHHHHHUUUUUUUUUUUUUUUUg
iPPPPPPPPPPPPPPPPVVVVVVVnAoooooooqqqqqqqqBBBBBBBBBBBBBBBBBBBBBBBBBHHHHHHHHHHHHHHHHHHHHHHHHHHHHHHHHHHHHHHHHHHHHHHHHHHHHHHHHHUUUUUUUUUUUUUUUUg
iPPPPPPPPPPPPPPPPVVVVVVVnAoooooooqqqqqqqqkkkkkkkkkkkkkkkkkkkkkkkkkZZZZHHHHHHHHHHHHHHHHHHHHHHHHHHHHHHHHHHHHHHHHHHHHHHHHHHHHHUUUUUUUUUUUUUUUUg
iPPPPPPPPPPPPPPPPVVVVVVVnAoooooooqqqqqqqqkkkkkkkkkkkkkkkkkkkkkkkkkZZZZHHHHHHHHHHHHHHHHHHHHHHHHHHHHHHHHHHHHHHHHHHHHHHHHHHHHHUUUUUUUUUUUUUUUUg
iPPPPPPPPPPPPPPPPVVVVVVVnAoooooooqqqqqqqqkkkkkkkkkkkkkkkkkkkkkkkkkZZZZHHHHHHHHHHHHHHHHHHHHHHHHHHHHHHHHHHHHHHHHHHHHHHHHHHHHHHUUUUUUUUUUUUUUUg
iPPPPPPPPPPPPPPPPVVVVVVVnAoooooooqqqqqqqqkkkkkkkkkkkkkkkkkkkkkkkkkZZZZHHHHHHHHHHHHHHHHHHHHHHHHHHHHHHHHHHHHHHHHHHHHHHHHHHHHHHUUUUUUUUUUUUUUUg
iPPPPPPPPPPPPPPPPVVVVVVVnAoooooooqqqqqqqqkkkkkkkkkkkkkkkkkkkkkkkkkZZZZHHHHHHHHHHHHHHHHHHHHHHHHHHHHHHHHHHHHHHHHHHHHHHHHHHHHHHUUUUUUUUUUUUUUUg
iPPPPPPPPPPPPPPPPPVVVVVVnAoooooooqqqqqqqqkkkkkkkkkkkkkkkkkkkkkkkkkZZZZHHHHHHHHHHHHHHHHHHHHHHHHHHHHHHHHHHHHHHHHHHHHHHHHHHHHHHUUUUUUUUUUUUUUUg
iPPPPPPPPPPPPPPPPPVVVVVVnAoooooooqqqqqqqqkkkkkkkkkkkkkkkkkkkkkkkkkZZZZHHHHHHHHHHHHHHHHHHHHHHHHHHHHHHHHHHHHHHHHHHHHHHHHHHHHHHUUUUUUUUUUUUUUUg
EhhhhPPPPPPPPPPPPPVVVVVVnAoooooooqqqqqqqqkkkkkkkkkkkkkkkkkkkkkkkkkZZZZHHHHHHHHHHHHHHHHHHHHHHHHHHHHHHHHHHHHHHHHHHHHHHHHHHHHHHUUUUUUUUUUUUUUUg
EhhhhhhhhPPPPPPPPPVVVVVVnAoooooooqqqqqqqqkkkkkkkkkkkkkkkkkkkkkkkkkZZZZHHHHHHHHHHHHHHHHHHHHHHHHHHHHHHHHHHHHHHHHHHHHHHHHHHHHHHUUUUUUUUUUUUUUUg
EhhhhhhhhhhPPPPPPVVVVVVVnAoooooooqqqqqqqqkkkkkkkkkkkkkkkkkkkkkkkkkZZZZHHHHHHHHHHHHHHHHHHHHHHHHHHHHHHHHHHHHHHHHHHHHHHHHHHHHHHUUUUUUUUUUUUUUUg
EhhhhhhhhhhhhPPPPVVVVVVVnAoooooooqqqqqqqqkkkkkkkkkkkkkkkkkkkkkkkkkZZZZHHHHHHHHHHHHHHHHHHHHHHHHHHHHHHHHHHHHHHHHHHHHHHHHHHHHHUUUUUUUUUUUUUUUUg
EhhhhhhhhhhhhhhhPPVVVVVVnAoooooooqqqqqqqqkkkkkkkkkkkkkkkkkkkkkkkkkZZZZHHHHHHHHHHHHHHHHHHHHHHHHHHHHHHHHHHHHHHHHHHHHHHHHHHHHHUUUUUUUUUUUUUUUUg
EhhhhhhhhhhhhhhhhPVVVVVVnAoooooooqqqqqqqqkkkkkkkkkkkkkkkkkkkkkkkkkZZZZHHHHHHHHHHHHHHHHHHHHHHHHHHHHHHHHHHHHHHHHHHHHHHHHHHHHHUUUUUUUUUUUUUUUUg
EhhhhhhhhhhhhhhhhPVVVVVVnAoooooooqqqqqqqqkkkkkkkkkkkkkkkkkkkkkkkkkZZZZHHHHHHHHHHHHHHHHHHHHHHHHHHHHHHHHHHHHHHHHHHHHHHHHHHHHHUUUUUUUUUUUUUUUUg
EhhhhhhhhhhhhhhhhhVVVVVVnAoooooooqqqqqqqqkkkkkkkkkkkkkkkkkkkkkkkkkZZZZHHHHHHHHHHHHHHHHHHHHHHHHHHHHHHHHHHHHHHHHHHHHHHHHHHHHHUUUUUUUUUUUUUUUUg
EhhhhhhhhhhhhhhhhhhVVVVVnAoooooooqqqqqqqqkkkkkkkkkkkkkkkkkkkkkkkkkZZZZHHHHHHHHHHHHHHHHHHHHHHHHHHHHHHHHHHHHHHHHHHHHHHHHHHHHHUUUUUUUUUUUUUUUUg
EhhhhhhhhhhhhhhhhhhhVVVVnAoooooooqqqqqqqqkkkkkkkkkkkkkkkkkkkkkkkkkZZZZHHHHHHHHHHHHHHHHHHHHHHHHHHHHHHHHHHHHHHHHHHHHHHHHHHHHHUUUUUUUUUUUUUUUUg
EhhhhhhhhhhhhhhhhhhhhVVVnAoooooooqqqqqqqqkkkkkkkkkkkkkkkkkkkkkkkkkZZZZHHHHHHHHHHHHHHHHHHHHHHHHHHHHHHHHHHHHHHHHHHHHHHHHHHHHUUUUUUUUUUUUUUUUUg
EhhhhhhhhhhhhhhhhhhhhhVVnAoooooooqqqqqqqqkkkkkkkkkkkkkkkkkkkkkkkkkZZZZHHHHHHHHHHHHHHHHHHHHHHHHHHHHHHHHHHHHHHHHHHHHHHHHHHHUUUUUUUUUUUUUUUUUUg
EhhhhhhhhhhhhhhhhhhhhhhhnAoooooooqqqqqqqqkkkkkkkkkkkkkkkkkkkkkkkkkZZZZHHHHHHHHHHHHHHHHHHHHHHHHHHHHHHHHHHHHHHHHHHHHHHHHHHHUUUUUUUUUUUUUUUUUUg
EhhhhhhhhhhhhhhhhhhhhhhhhhoooooqqqqqqqqqqkkkkkkkkkkkkkkkkkkkkkkkkkZZZZHHHHHHHHHHHHHHHHHHHHHHHHHHHHHHHHHHHHHHHHHHHHHHHHHHUUUUUUUUUUUUUUUUUUUg
EhhhhhhhhhhhhhhhhhhhhhhhhhhhooqqqqqqqqqqkkkkkkkkkkkkkkkkkkkkkkkkkkZZZZHHHHHHHHHHHHHHHHHHHHHHHHHHHHHHHHHHHHHHHHHHHHHHHHHHUUUUUUUUUUUUUUUUUUUg
EhhhhhhhhhhhhhhhhhhhhhhhhhhhhhqqqqqqqqqqkkkkkkkkkkkkkkkkkkkkkkkkkkZZZZHHHHHHHHHHHHHHHHHHHHHHHHHHHHHHHHHHHHHHHHHHHHHHHHHUUUUUUUUUUUUUUUUUUUUg
EhhhhhhhhhhhhhhhhhhhhhhhhhhhhhhhhhqqqqqqkkkkkkkkkkkkkkkkkkkkkkkkkkZZZZHHHHHHHHHHHHHHHHHHHHHHHHHHHHHHHHHHHHHHHHHHHHHHHHHUUUUUUUUUUUUUUUUUUUUg
EhhhhhhhhhhhhhhhhhhhhhhhhhhhhhhhhhhhhqqqkkkkkkkkkkkkkkkkkkkkkkkkkkZZZZHHHHHHHHHHHHHHHHHHHHHHHHHHHHHHHHHHHHHHHHHHHHHHHHUUUUUUUUUUUUUUUUUUUUUg
EhhhhhhhhhhhhhhhhhhhhhhhhhhhhhhhhhhhhhhhhhkkkkkkkkkkkkkkkkkkkkkkkkZZZZHHHHHHHHHHHHHHHHHHHHHHHHHHHHHHHHHHHHHHHHHHHHHHHUUUUUUUUUUUUUUUUUUUUUUg
EhhhhhhhhhhhhhhhhhhhhhhhhhhhhhhhhhhhhhhhhhhhhhhhhhhhhhhkkkkkkkkkkkZZZZHHHHHHHHHHHHHHHHHHHHHHHHHHHHHHHHHHHHHHHHHHHHHHUUUUUUUUUUUUUUUUUUUUUUUg
EhhhhhhhhhhhhhhhhhhhhhhhhhhhhhhhhhhhhhhhhhhhhhhhhhhhhhhhhhhhhhhhhhUUUUUUUUUUUUUUUUUUUUUUUUUUHUHUHUUUUUUUUUUUUUUUUUUUUUUUUUUUUUUUUUUUUUUUUUUg
EhhhhhhhhhhhhhhhhhhhhhhhhhhhhhhhhhhhhhhhhhhhhhhhhhhhhhhhhhhhhhhhhhUUUUUUUUUUUUUUUUUUUUUUUUUUUUUUUUUUUUUUUUUUUUUUUUUUUUUUUUUUUUUUUUUUUUUUUUUg
EhhhhhhhhhhhhhhhhhhhhhhhhhhhhhhhhhhhhhhhhhhhhhhhhhhhhhhhhhhhhhhhhhUUUUUUUUUUUUUUUUUUUUUUUUUUUUUUUUUUUUUUUUUUUUUUUUUUUUUUUUUUUUUUUUUUUUUUUUUg
EhhhhhhhhhhhhhhhhhhhhhhhhhhhhhhhhhhhhhhhhhhhhhhhhhhhhhhhhhhhhhhhhhUUUUUUUUUUUUUUUUUUUUUUUUUUUUUUUUUUUUUUUUUUUUUUUUUUUUUUUUUUUUUUUUUUUUUUUUUg
EhhhhhhhhhhhhhhhhhhhhhhhhhhhhhhhhhhhhhhhhhhhhhhhhhhhhhhhhhhhhhhhhhUUUUUUUUUUUUUUUUUUUUUUUUUUUUUUUUUUUUUUUUUUUUUUUUUUUUUUUUUUUUUUUUUUUUUUUUUg
EhhhhhhhhhhhhhhhhhhhhhhhhhhhhhhhhhhhhhhhhhhhhhhhhhhhhhhhhhhhhhhhhhUUUUUUUUUUUUUUUUUUUUUUUUUUUUUUUUUUUUUUUUUUUUUUUUUUUUUUUUUUUUUUUUUUUUUUUUUg
EhhhhhhhhhhhhhhhhhhhhhhhhhhhhhhhhhhhhhhhhhhhhhhhhhhhhhhhhhhhhhhhhhUUUUUUUUUUUUUUUUUUUUUUUUUUUUUUUUUUUUUUUUUUUUUUUUUUUUUUUUUUUUUUUUUUUUUUUUUg
EhhhhhhhhhhhhhhhhhhhhhhhhhhhhhhhhhhhhhhhhhhhhhhhhhhhhhhhhhhhhhhhhhUUUUUUUUUUUUUUUUUUUUUUUUUUUUUUUUUUUUUUUUUUUUUUUUUUUUUUUUUUUUUUUUUUUUUUUUUg
EhhhhhhhhhhhhhhhhhhhhhhhhhhhhhhhhhhhhhhhhhhhhhhhhhhhhhhhhhhhhhhhhhUUUUUUUUUUUUUUUUUUUUUUUUUUUUUUUUUUUUUUUUUUUUUUUUUUUUUUUUUUUUUUUUUUUUUUUUUg
EhhhhhhhhhhhhhhhhhhhhhhhhhhhhhhhhhhhhhhhhhhhhhhhhhhhhhhhhhhhhhhhhhUUUUUUUUUUUUUUUUUUUUUUUUUUUUUUUUUUUUUUUUUUUUUUUUUUUUUUUUUUUUUUUUUUUUUUUUUg
EhhhhhhhhhhhhhhhhhhhhhhhhhhhhhhhhhhhhhhhhhhhhhhhhhhhhhhhhhhhhhhhhhUUUUUUUUUUUUUUUUUUUUUUUUUUUUUUUUUUUUUUUUUUUUUUUUUUUUUUUUUUUUUUUUUUUUUUUUUg
EhhhhhhhhhhhhhhhhhhhhhhhhhhhhhhhhhhhhhhhhhhhhhhhhhhhhhhhhhhhhhhhhhUUUUUUUUUUUUUUUUUUUUUUUUUUUUUUUUUUUUUUUUUUUUUUUUUUUUUUUUUUUUUUUUUUUUUUUUUg
EhhhhhhhhhhhhhhhhhhhhhhhhhhhhhhhhhhhhhhhhhhhhhhhhhhhhhhhhhhhhhhhhhUUUUUUUUUUUUUUUUUUUUUUUUUUUUUUUUUUUUUUUUUUUUUUUUUUUUUUUUUUUUUUUUUUUUUUUUUg
EhhhhhhhhhhhhhhhhhhhhhhhhhhhhhhhhhhhhhhhhhhhhhhhhhhhhhhhhhhhhhhhhhUUUUUUUUUUUUUUUUUUUUUUUUUUUUUUUUUUUUUUUUUUUUUUUUUUUUUUUUUUUUUUUUUUUUUUUUUg
EhhhhhhhhhhhhhhhhhhhhhhhhhhhhhhhhhhhhhhhhhhhhhhhhhhhhhhhhhhhhhhhhhUUUUUUUUUUUUUUUUUUUUUUUUUUUUUUUUUUUUUUUUUUUUUUUUUUUUUUUUUUUUUUUUUUUUUUUUUg
EhhhhhhhhhhhhhhhhhhhhhhhhhhhhhhhhhhhhhhhhhhhhhhhhhhhhhhhhhhhhhhhhhUUUUUUUUUUUUUUUUUUUUUUUUUUUUUUUUUUUUUUUUUUUUUUUUUUUUUUUUUUUUUUUUUUUUUUUUUg
EhhhhhhhhhhhhhhhhhhhhhhhhhhhhhhhhhhhhhhhhhhhhhhhhhhhhhhhhhhhhhhhhhUUUUUUUUUUUUUUUUUUUUUUUUUUUUUUUUUUUUUUUUUUUUUUUUUUUUUUUUUUUUUUUUUUUUUUUUUg
EhhhhhhhhhhhhhhhhhhhhhhhhhhhhhhhhhhhhhhhhhhhhhhhhhhhhhhhhhhhhhhhhhUUUUUUUUUUUUUUUUUUUUUUUUUUUUUUUUUUUUUUUUUUUUUUUUUUUUUUUUUUUUUUUUUUUUUUUUUg
EhhhhhhhhhhhhhhhhhhhhhhhhhhhhhhhhhhhhhhhhhhhhhhhhhhhhhhhhhhhhhhhhhUUUUUUUUUUUUUUUUUUUUUUUUUUUUUUUUUUUUUUUUUUUUUUUUUUUUUUUUUUUUUUUUUUUUUUUUUg
EhhhhhhhhhhhhhhhhhhhhhhhhhhhhhhhhhhhhhhhhhhhhhhhhhhhhhhhhhhhhhhhhhUUUUUUUUUUUUUUUUUUUUUUUUUUUUUUUUUUUUUUUUUUUUUUUUUUUUUUUUUUUUUUUUUUUUUUUUUg
EhhhhhhhhhhhhhhhhhhhhhhhhhhhhhhhhhhhhhhhhhhhhhhhhhhhhhhhhhhhhhhhhhUUUUUUUUUUUUUUUUUUUUUUUUUUUUUUUUUUUUUUUUUUUUUUUUUUUUUUUUUUUUUUUUUUUUUUUUUg
EhhhhhhhhhhhhhhhhhhhhhhhhhhhhhhhhhhhhhhhhhhhhhhhhhhhhhhhhhhhhhhhhhUUUUUUUUUUUUUUUUUUUUUUUUUUUUUUUUUUUUUUUUUUUUUUUUUUUUUUUUUUUUUUUUUUUUUUUUUg
EhhhhhhhhhhhhhhhhhhhhhhhhhhhhhhhhhhhhhhhhhhhhhhhhhhhhhhhhhhhhhhhhhUUUUUUUUUUUUUUUUUUUUUUUUUUUUUUUUUUUUUUUUUUUUUUUUUUUUUUUUUUUUUUUUUUUUUUUUUg
EhhhhhhhhhhhhhhhhhhhhhhhhhhhhhhhhhhhhhhhhhhhhhhhhhhhhhhhhhhhhhhhhhUUUUUUUUUUUUUUUUUUUUUUUUUUUUUUUUUUUUUUUUUUUUUUUUUUUUUUUUUUUUUUUUUUUUUUUUUg
EhhhhhhhhhhhhhhhhhhhhhhhhhhhhhhhhhhhhhhhhhhhhhhhhhhhhhhhhhhhhhhhhhUUUUUUUUUUUUUUUUUUUUUUUUUUUUUUUUUUUUUUUUUUUUUUUUUUUUUUUUUUUUUUUUUUUUUUUUUg
EhhhhhhhhhhhhhhhhhhhhhhhhhhhhhhhhhhhhhhhhhhhhhhhhhhhhhhhhhhhhhhhhhUUUUUUUUUUUUUUUUUUUUUUUUUUUUUUUUUUUUUUUUUUUUUUUUUUUUUUUUUUUUUUUUUUUUUUUUUg
EhhhhhhhhhhhhhhhhhhhhhhhhhhhhhhhhhhhhhhhhhhhhhhhhhhhhhhhhhhhhhhhhhUUUUUUUUUUUUUUUUUUUUUUUUUUUUUUUUUUUUUUUUUUUUUUUUUUUUUUUUUUUUUUUUUUUUUUUUUg
EhhhhhhhhhhhhhhhhhhhhhhhhhhhhhhhhhhhhhhhhhhhhhhhhhhhhhhhhhhhhhhhhhUUUUUUUUUUUUUUUUUUUUUUUUUUUUUUUUUUUUUUUUUUUUUUUUUUUUUUUUUUUUUUUUUUUUUUUUUg
EEEEEEEEEEEEEEEEEEEEEEEEEEEEEEEEEEEEEEEEEEEEEEEEEEEEEEEEEEEEEEEEEEgggggggggggggggggggggggggggggggggggggggggggggggggggggggggggggggggggggggggg
"}
